//MAP CONVERTED BY dmm2tgm.py THIS HEADER COMMENT PREVENTS RECONVERSION, DO NOT REMOVE
"a" = (
/turf/open/floor/whitebluefull/northeast,
/area/bigredv2/outside/telecomm/warehouse)
"b" = (
/turf/open/floor,
/area/bigredv2/outside/telecomm/warehouse)
"c" = (
/turf/open/floor/plating/warnplate/north,
/area/bigredv2/outside/telecomm/warehouse)
"d" = (
/obj/structure/pipes/standard/simple/hidden/green,
/turf/open/floor/plating/warnplate/north,
/area/bigredv2/outside/telecomm/warehouse)
"e" = (
/obj/structure/largecrate/random/barrel/red,
/turf/open/floor/bot/north,
/area/bigredv2/outside/telecomm/warehouse)
"f" = (
/obj/structure/machinery/light{
	dir = 1
	},
/obj/structure/largecrate/random/case/small,
/turf/open/floor/bot/north,
/area/bigredv2/outside/telecomm/warehouse)
"g" = (
/obj/structure/xenoautopsy/tank/larva,
/turf/open/floor/bot/north,
/area/bigredv2/outside/telecomm/warehouse)
"h" = (
/obj/structure/xenoautopsy/tank/broken,
/turf/open/floor/bot/north,
/area/bigredv2/outside/telecomm/warehouse)
"i" = (
/turf/closed/wall/solaris/reinforced,
/area/bigredv2/outside/telecomm/warehouse)
"j" = (
/turf/open/floor/bot/north,
/area/bigredv2/outside/telecomm/warehouse)
"k" = (
/obj/structure/pipes/standard/simple/hidden/green,
/turf/open/floor,
/area/bigredv2/outside/telecomm/warehouse)
"l" = (
/obj/structure/largecrate/random/case/double,
/turf/open/floor/bot/north,
/area/bigredv2/outside/telecomm/warehouse)
"m" = (
/obj/item/shard,
/turf/open/floor/loadingarea/north,
/area/bigredv2/outside/telecomm/warehouse)
"n" = (
/turf/open/floor/plating/warnplate/west,
/area/bigredv2/outside/telecomm/warehouse)
"p" = (
/obj/structure/pipes/standard/simple/hidden/green{
	dir = 4
	},
/turf/open/floor/plating/warnplate/west,
/area/bigredv2/outside/telecomm/warehouse)
"q" = (
/obj/structure/pipes/standard/simple/hidden/green{
	dir = 4
	},
/turf/open/floor,
/area/bigredv2/outside/telecomm/warehouse)
"r" = (
/obj/effect/landmark/hunter_primary,
/obj/structure/pipes/standard/simple/hidden/green{
	dir = 4
	},
/turf/open/floor,
/area/bigredv2/outside/telecomm/warehouse)
"s" = (
/obj/structure/pipes/standard/manifold/hidden/green,
/turf/open/floor,
/area/bigredv2/outside/telecomm/warehouse)
"t" = (
/turf/open/floor/loadingarea/north,
/area/bigredv2/outside/telecomm/warehouse)
"u" = (
/obj/structure/machinery/light{
	dir = 8
	},
/turf/open/floor/whitebluefull/northeast,
/area/bigredv2/outside/telecomm/warehouse)
"v" = (
/obj/structure/cargo_container/horizontal/blue/top,
/turf/open/floor/whitebluefull/northeast,
/area/bigredv2/outside/telecomm/warehouse)
"w" = (
/obj/structure/cargo_container/horizontal/blue/middle,
/turf/open/floor/whitebluefull/northeast,
/area/bigredv2/outside/telecomm/warehouse)
"x" = (
/obj/structure/prop/dam/crane/damaged,
/turf/open/floor/whitebluefull/northeast,
/area/bigredv2/outside/telecomm/warehouse)
"y" = (
/obj/structure/cargo_container/horizontal/blue/bottom,
/turf/open/floor/whitebluefull/northeast,
/area/bigredv2/outside/telecomm/warehouse)
"z" = (
/obj/structure/machinery/light,
/obj/structure/largecrate/random/barrel/red,
/turf/open/floor/bot/north,
/area/bigredv2/outside/telecomm/warehouse)
"A" = (
/obj/structure/surface/rack,
/obj/item/alienjar,
/turf/open/floor/bot/north,
/area/bigredv2/outside/telecomm/warehouse)
"B" = (
/obj/structure/machinery/light,
/turf/open/floor/whitebluefull/northeast,
/area/bigredv2/outside/telecomm/warehouse)
"D" = (
/obj/effect/landmark/static_comms/net_one,
/turf/open/floor/bcircuit,
/area/bigredv2/outside/telecomm/warehouse)
"H" = (
/obj/effect/decal/warning_stripes{
	icon_state = "NE-out";
	pixel_x = 1;
	pixel_y = 1
	},
/turf/open/floor/plating/warnplate/southwest,
/area/bigredv2/outside/telecomm/warehouse)
"J" = (
/obj/item/stack/sheet/metal/med_large_stack,
/obj/structure/closet/crate,
/turf/open/floor/bot/north,
/area/bigredv2/outside/telecomm/warehouse)
"K" = (
/turf/open/floor/bcircuit,
/area/bigredv2/outside/telecomm/warehouse)
"O" = (
/obj/effect/decal/warning_stripes{
	icon_state = "E";
	pixel_x = 1
	},
/turf/open/floor/plating/warnplate/west,
/area/bigredv2/outside/telecomm/warehouse)
"P" = (
/obj/structure/closet/crate,
/obj/item/stack/sheet/plasteel/med_small_stack,
/turf/open/floor/bot/north,
/area/bigredv2/outside/telecomm/warehouse)
"S" = (
/obj/structure/machinery/power/apc/no_power/north,
/obj/effect/decal/warning_stripes{
	icon_state = "W";
	layer = 2.5;
	pixel_x = -1
	},
/turf/open/floor/plating/warnplate/east,
/area/bigredv2/outside/telecomm/warehouse)
"T" = (
/obj/effect/decal/warning_stripes{
	icon_state = "NW-out";
	pixel_x = -1;
	pixel_y = 1
	},
/turf/open/floor/plating/warnplate/southeast,
/area/bigredv2/outside/telecomm/warehouse)
"U" = (
/obj/item/shard,
/turf/open/floor/bot/north,
/area/bigredv2/outside/telecomm/warehouse)
"V" = (
/obj/effect/decal/warning_stripes{
	icon_state = "N";
	pixel_y = 1
	},
/turf/open/floor/plating/warnplate,
/area/bigredv2/outside/telecomm/warehouse)
"Z" = (
/obj/effect/decal/warning_stripes{
	icon_state = "W";
	layer = 2.5;
	pixel_x = -1
	},
/turf/open/floor/plating/warnplate/east,
/area/bigredv2/outside/telecomm/warehouse)

(1,1,1) = {"
i
i
i
n
p
n
i
i
i
i
"}
(2,1,1) = {"
i
O
O
H
q
b
u
a
a
i
"}
(3,1,1) = {"
i
K
D
V
q
b
v
w
y
i
"}
(4,1,1) = {"
i
K
K
V
q
b
a
a
a
i
"}
(5,1,1) = {"
i
S
Z
T
q
b
a
a
a
i
"}
(6,1,1) = {"
i
g
U
b
r
b
v
w
y
i
"}
(7,1,1) = {"
i
h
U
b
q
b
a
a
a
i
"}
(8,1,1) = {"
i
f
j
b
q
b
t
j
z
i
"}
(9,1,1) = {"
c
b
b
b
q
b
b
g
g
i
"}
(10,1,1) = {"
c
b
b
b
q
b
m
h
g
i
"}
(11,1,1) = {"
d
k
k
k
s
b
b
U
A
i
"}
(12,1,1) = {"
i
l
j
b
q
b
t
j
P
i
"}
(13,1,1) = {"
i
f
j
b
q
b
a
x
B
i
"}
(14,1,1) = {"
i
l
j
b
q
b
a
a
a
i
"}
(15,1,1) = {"
i
e
j
b
q
b
v
w
y
i
"}
(16,1,1) = {"
i
J
j
b
q
b
a
a
a
i
"}
