//MAP CONVERTED BY dmm2tgm.py THIS HEADER COMMENT PREVENTS RECONVERSION, DO NOT REMOVE
"a" = (
/obj/docking_port/mobile/sselevator/two,
/turf/closed/shuttle/elevator/window/southwest,
/area/shuttle/multiz_elevator)
"b" = (
/obj/structure/machinery/gear/elevator{
	dir = 4
	},
/turf/closed/shuttle/elevator/gears/sci/west,
/area/shuttle/multiz_elevator)
"g" = (
/turf/closed/shuttle/elevator/multiz/west,
/area/shuttle/multiz_elevator)
"i" = (
/turf/closed/shuttle/elevator/window/north,
/area/shuttle/multiz_elevator)
"j" = (
/turf/closed/shuttle/elevator/window/a_closing/one,
/area/shuttle/multiz_elevator)
"o" = (
/turf/closed/shuttle/elevator/window/southeast,
/area/shuttle/multiz_elevator)
"p" = (
/turf/closed/shuttle/elevator/multiz/east,
/area/shuttle/multiz_elevator)
"q" = (
/turf/open/shuttle/elevator/multiz/wv,
/area/shuttle/multiz_elevator)
"t" = (
/obj/structure/machinery/computer/shuttle/shuttle_control/sselevator/two{
	pixel_y = 38
	},
/turf/open/shuttle/elevator/multiz/wv,
/area/shuttle/multiz_elevator)
"v" = (
/turf/closed/shuttle/elevator/window/northwest,
/area/shuttle/multiz_elevator)
"w" = (
/obj/structure/machinery/light/double/blue{
	dir = 1
	},
/turf/open/shuttle/elevator/multiz/grating,
/area/shuttle/multiz_elevator)
"C" = (
/obj/structure/machinery/door/airlock/multi_tile/almayer/dropshiprear/blastdoor/elevator/two/control,
/turf/open/shuttle/elevator/multiz/wg,
/area/shuttle/multiz_elevator)
"F" = (
/turf/closed/shuttle/elevator/window/northeast,
/area/shuttle/multiz_elevator)
"H" = (
/turf/open/shuttle/elevator/multiz/wg,
/area/shuttle/multiz_elevator)
"I" = (
/turf/closed/shuttle/elevator/window/a_closing,
/area/shuttle/multiz_elevator)
"K" = (
/turf/open/shuttle/elevator/multiz/grating,
/area/shuttle/multiz_elevator)
"S" = (
/obj/structure/machinery/gear/elevator,
/turf/closed/shuttle/elevator/gears/sci,
/area/shuttle/multiz_elevator)

(1,1,1) = {"
v
i
i
i
i
j
a
"}
(2,1,1) = {"
p
t
K
K
K
q
p
"}
(3,1,1) = {"
S
K
K
K
K
K
C
"}
(4,1,1) = {"
g
w
q
q
q
K
H
"}
(5,1,1) = {"
b
K
K
K
K
K
H
"}
(6,1,1) = {"
g
q
K
K
K
q
g
"}
(7,1,1) = {"
F
i
i
i
i
I
o
"}
