//MAP CONVERTED BY dmm2tgm.py THIS HEADER COMMENT PREVENTS RECONVERSION, DO NOT REMOVE
"a" = (
/obj/docking_port/mobile/sselevator/one,
/turf/closed/shuttle/elevator/window/southwest,
/area/shuttle/multiz_elevator)
"b" = (
/obj/structure/machinery/gear/elevator{
	dir = 4
	},
/turf/closed/shuttle/elevator/gears/sci/west,
/area/shuttle/multiz_elevator)
"d" = (
/obj/structure/machinery/door/airlock/multi_tile/almayer/dropshiprear/blastdoor/elevator{
	floor = "control";
	density = 0
	},
/turf/open/shuttle/elevator/multiz/wg,
/area/shuttle/multiz_elevator)
"g" = (
/turf/closed/shuttle/elevator/multiz/west,
/area/shuttle/multiz_elevator)
"i" = (
/turf/closed/shuttle/elevator/window/north,
/area/shuttle/multiz_elevator)
"j" = (
/turf/closed/shuttle/elevator/window/a_closing/one,
/area/shuttle/multiz_elevator)
"o" = (
/turf/closed/shuttle/elevator/window/southeast,
/area/shuttle/multiz_elevator)
"p" = (
/turf/closed/shuttle/elevator/multiz/east,
/area/shuttle/multiz_elevator)
"q" = (
/turf/open/shuttle/elevator/multiz/wv,
/area/shuttle/multiz_elevator)
"t" = (
/obj/structure/machinery/light/double/blue,
/turf/open/shuttle/elevator/multiz/grating,
/area/shuttle/multiz_elevator)
"v" = (
/turf/closed/shuttle/elevator/window/northwest,
/area/shuttle/multiz_elevator)
"w" = (
/turf/closed/shuttle/elevator/window/west,
/area/shuttle/multiz_elevator)
"F" = (
/turf/closed/shuttle/elevator/window/northeast,
/area/shuttle/multiz_elevator)
"H" = (
/turf/open/shuttle/elevator/multiz/wg,
/area/shuttle/multiz_elevator)
"I" = (
/turf/closed/shuttle/elevator/window/a_closing,
/area/shuttle/multiz_elevator)
"K" = (
/turf/open/shuttle/elevator/multiz/grating,
/area/shuttle/multiz_elevator)
"S" = (
/obj/structure/machinery/gear/elevator,
/turf/closed/shuttle/elevator/gears/sci,
/area/shuttle/multiz_elevator)
"U" = (
/obj/structure/machinery/computer/shuttle/shuttle_control/sselevator{
	elevator_id = "normal_elevator";
	floor = "control";
	pixel_y = 38
	},
/turf/open/shuttle/elevator/multiz/wv,
/area/shuttle/multiz_elevator)

(1,1,1) = {"
v
i
i
i
i
j
a
"}
(2,1,1) = {"
p
q
K
K
K
q
w
"}
(3,1,1) = {"
d
K
K
K
K
K
S
"}
(4,1,1) = {"
H
K
q
q
q
t
g
"}
(5,1,1) = {"
H
K
K
K
K
K
b
"}
(6,1,1) = {"
g
U
K
K
K
q
w
"}
(7,1,1) = {"
F
i
i
i
i
I
o
"}
