//MAP CONVERTED BY dmm2tgm.py THIS HEADER COMMENT PREVENTS RECONVERSION, DO NOT REMOVE
"aa" = (
/turf/closed/wall/r_wall/prison_unmeltable,
/area/prisonru/oob)
"ab" = (
/obj/item/stack/sheet/metal{
	pixel_x = -2;
	pixel_y = 3
	},
/turf/open/floor/prison/red/north,
/area/prisonru/station/hallway/entrance)
"aB" = (
/obj/structure/machinery/light/double/blue{
	dir = 8;
	pixel_x = -10
	},
/turf/open/floor/prison/floor_plate/southwest,
/area/prisonru/station/hallway/entrance)
"aL" = (
/obj/structure/pipes/standard/simple/hidden/dark{
	dir = 4
	},
/obj/item/stack/rods,
/turf/open/floor/plating/plating_catwalk/prison,
/area/prisonru/station/hallway/entrance)
"bt" = (
/obj/structure/pipes/standard/manifold/hidden/dark{
	dir = 8
	},
/obj/structure/disposalpipe/segment,
/turf/open/floor/plating/plating_catwalk/prison,
/area/prisonru/station/hallway/entrance)
"bP" = (
/obj/structure/barricade/handrail/type_b{
	dir = 1;
	pixel_y = 13
	},
/obj/structure/flora/pottedplant{
	icon_state = "pottedplant_21";
	layer = 3.1;
	pixel_y = 11
	},
/turf/open/floor/prison,
/area/prisonru/station/hallway/entrance)
"cn" = (
/obj/effect/decal/cleanable/blood/drip,
/turf/open/floor/prison,
/area/prisonru/station/hallway/entrance)
"cp" = (
/obj/item/stack/sheet/metal{
	pixel_x = -2;
	pixel_y = 3
	},
/turf/open/floor/prison,
/area/prisonru/station/security/barracks)
"cu" = (
/obj/structure/barricade/handrail/wire{
	dir = 4;
	pixel_x = -3
	},
/obj/effect/decal/siding{
	icon_state = "siding4"
	},
/obj/structure/barricade/handrail/wire{
	pixel_y = 2
	},
/turf/open/floor/prison,
/area/prisonru/station/hallway/entrance)
"ds" = (
/obj/effect/decal/cleanable/blood/drip,
/obj/structure/barricade/handrail/wire{
	dir = 4;
	pixel_x = -3
	},
/obj/effect/decal/siding{
	icon_state = "siding4"
	},
/turf/open/floor/prison,
/area/prisonru/station/hallway/entrance)
"dI" = (
/obj/structure/pipes/standard/simple/hidden/dark{
	dir = 6
	},
/turf/open/floor/prison,
/area/prisonru/station/security/barracks)
"ex" = (
/obj/structure/pipes/standard/simple/hidden/dark,
/obj/structure/disposalpipe/segment,
/obj/effect/decal/cleanable/dirt,
/turf/open/floor/plating/plating_catwalk/prison,
/area/prisonru/station/hallway/entrance)
"ff" = (
/obj/structure/window/framed/prison/reinforced/hull,
/obj/structure/blocker/invisible_wall,
/turf/open/floor/plating/prison,
/area/prisonru/lz/near_lzI)
"fo" = (
/obj/structure/prop/hybrisa/misc/redmeter{
	pixel_y = 32
	},
/obj/item/tool/wet_sign{
	pixel_y = 18
	},
/obj/item/tool/wet_sign{
	pixel_x = -11;
	pixel_y = 21
	},
/obj/item/reagent_container/glass/bucket/mopbucket{
	pixel_y = 10
	},
/turf/open/floor/prison,
/area/prisonru/station/security/barracks)
"fA" = (
/obj/effect/decal/cleanable/blood/drip,
/turf/open/floor/plating/plating_catwalk/prison,
/area/prisonru/station/hallway/entrance)
"fV" = (
/obj/structure/pipes/standard/simple/hidden/dark{
	dir = 4
	},
/obj/effect/decal/cleanable/dirt,
/turf/open/floor/prison,
/area/prisonru/station/hallway/entrance)
"gg" = (
/obj/structure/bed/chair/comfy{
	dir = 4
	},
/obj/effect/decal/cleanable/dirt,
/obj/structure/sign/poster/safety{
	pixel_x = -26;
	pixel_y = 8
	},
/obj/structure/sign/poster/safety{
	pixel_x = -24;
	pixel_y = 17
	},
/turf/open/floor/prison/floor_plate/southwest,
/area/prisonru/station/hallway/entrance)
"gv" = (
/obj/structure/pipes/vents/pump{
	dir = 8
	},
/obj/effect/decal/cleanable/dirt,
/obj/effect/decal/siding{
	icon_state = "siding4"
	},
/obj/item/stack/rods,
/obj/structure/barricade/handrail/wire{
	dir = 4;
	pixel_x = -3
	},
/turf/open/floor/prison,
/area/prisonru/station/hallway/entrance)
"gD" = (
/obj/structure/barricade/handrail/wire{
	dir = 4;
	pixel_x = -3
	},
/obj/effect/decal/siding{
	icon_state = "siding4"
	},
/turf/open/floor/prison/redfull,
/area/prisonru/station/hallway/entrance)
"hD" = (
/turf/closed/wall/prison,
/area/prisonru/station/hallway/entrance)
"iS" = (
/obj/structure/window/framed/prison/reinforced/hull,
/obj/structure/blocker/invisible_wall,
/turf/open/floor/plating/prison,
/area/prisonru/station/security/barracks)
"iU" = (
/obj/effect/decal/warning_stripes{
	icon_state = "SW-out"
	},
/obj/structure/sign/safety/food_storage{
	pixel_y = -9;
	pixel_x = -17
	},
/turf/open/floor/prison/floor_plate/southwest,
/area/prisonru/station/hallway/entrance)
"jn" = (
/obj/structure/window/framed/prison/reinforced,
/turf/open/floor/plating/prison,
/area/prisonru/lz/near_lzI)
"lc" = (
/obj/structure/sign/safety/north{
	pixel_y = 7;
	pixel_x = 32
	},
/obj/structure/sign/safety/landingzone{
	pixel_y = -8;
	pixel_x = 32
	},
/turf/open/floor/prison,
/area/prisonru/station/hallway/entrance)
"lM" = (
/obj/item/stack/rods,
/obj/structure/barricade/handrail/wire{
	pixel_y = 2
	},
/turf/open/floor/prison,
/area/prisonru/station/hallway/entrance)
"mh" = (
/obj/structure/pipes/standard/manifold/hidden/dark{
	dir = 4
	},
/obj/structure/disposalpipe/segment,
/turf/open/floor/plating/plating_catwalk/prison,
/area/prisonru/station/hallway/entrance)
"mq" = (
/obj/structure/pipes/standard/simple/hidden/dark{
	dir = 4
	},
/obj/item/stack/rods,
/obj/item/stack/rods,
/turf/open/floor/plating/plating_catwalk/prison,
/area/prisonru/station/hallway/entrance)
"mu" = (
/turf/open/floor/plating/plating_catwalk/prison,
/area/prisonru/station/hallway/entrance)
"mA" = (
/obj/structure/barricade/handrail/type_b{
	layer = 3.4
	},
/obj/structure/flora/pottedplant{
	icon_state = "pottedplant_2";
	pixel_x = 8;
	pixel_y = 15
	},
/obj/structure/flora/pottedplant{
	icon_state = "pottedplant_2";
	pixel_x = -8;
	pixel_y = 15
	},
/turf/open/floor/prison,
/area/prisonru/station/hallway/entrance)
"mK" = (
/obj/structure/pipes/standard/simple/hidden/dark{
	dir = 9
	},
/obj/structure/disposalpipe/segment{
	dir = 8;
	icon_state = "pipe-c"
	},
/turf/open/floor/plating/plating_catwalk/prison,
/area/prisonru/station/hallway/entrance)
"na" = (
/obj/structure/machinery/door/airlock/multi_tile/almayer/generic{
	name = "Staff Hallway"
	},
/turf/open/floor/prison,
/area/prisonru/station/hallway/entrance)
"ne" = (
/obj/structure/pipes/standard/simple/hidden/dark{
	dir = 6
	},
/obj/structure/disposalpipe/segment{
	dir = 4;
	icon_state = "pipe-c"
	},
/turf/open/floor/plating/plating_catwalk/prison,
/area/prisonru/station/hallway/entrance)
"nr" = (
/obj/structure/surface/table/reinforced/prison{
	dir = 1;
	color = "#8e98a0"
	},
/turf/open/floor/prison/redfull,
/area/prisonru/station/hallway/entrance)
"nX" = (
/obj/structure/sign/safety/landingzone{
	pixel_y = 7;
	pixel_x = 15
	},
/obj/structure/sign/safety/south{
	pixel_y = -5;
	pixel_x = 15
	},
/turf/closed/wall/prison,
/area/prisonru/station/recreation/staff)
"oK" = (
/turf/open/floor/prison/redfull,
/area/prisonru/station/hallway/entrance)
"pq" = (
/turf/closed/wall/r_wall/prison_unmeltable,
/area/prisonru/lz/near_lzI)
"pw" = (
/obj/structure/bed/chair/comfy{
	dir = 4
	},
/obj/structure/machinery/door_control{
	id = "kitchen";
	name = "Kitchen Access";
	pixel_x = -22;
	pixel_y = 10
	},
/obj/effect/decal/warning_stripes{
	icon_state = "NW-out"
	},
/turf/open/floor/prison/floor_plate/southwest,
/area/prisonru/station/hallway/entrance)
"pF" = (
/obj/structure/bed/chair/comfy,
/obj/structure/barricade/handrail/wire{
	dir = 1;
	pixel_y = 13
	},
/obj/effect/decal/siding,
/turf/open/floor/prison/red,
/area/prisonru/station/hallway/entrance)
"qo" = (
/obj/structure/pipes/standard/simple/hidden/dark,
/obj/structure/disposalpipe/segment,
/obj/effect/decal/cleanable/blood/drip,
/turf/open/floor/plating/plating_catwalk/prison,
/area/prisonru/station/hallway/entrance)
"qM" = (
/obj/structure/window/framed/prison/reinforced/hull,
/obj/structure/blocker/invisible_wall,
/turf/open/floor/plating/prison,
/area/prisonru/station/hallway/entrance)
"rd" = (
/obj/structure/window/framed/prison/reinforced,
/obj/effect/decal/cleanable/dirt,
/turf/open/floor/plating/prison,
/area/prisonru/station/hallway/entrance)
"rJ" = (
/obj/structure/pipes/standard/simple/hidden/dark{
	dir = 4
	},
/turf/open/floor/prison,
/area/prisonru/station/hallway/entrance)
"sh" = (
/obj/structure/machinery/power/apc/no_power/west,
/obj/structure/largecrate/random/barrel/brown,
/turf/open/floor/prison/floor_plate/southwest,
/area/prisonru/station/hallway/entrance)
"sS" = (
/obj/structure/bed/chair/comfy{
	dir = 4
	},
/obj/effect/decal/cleanable/blood/drip,
/turf/open/floor/prison/floor_plate/southwest,
/area/prisonru/station/hallway/entrance)
"sW" = (
/obj/structure/pipes/standard/simple/hidden/dark{
	dir = 4
	},
/turf/open/floor/plating/plating_catwalk/prison,
/area/prisonru/station/hallway/entrance)
"tk" = (
/obj/effect/decal/cleanable/blood,
/obj/structure/bed/chair/comfy{
	dir = 4
	},
/obj/structure/machinery/light/double/blue{
	dir = 8;
	pixel_x = -10
	},
/turf/open/floor/prison/floor_plate/southwest,
/area/prisonru/station/hallway/entrance)
"vt" = (
/obj/structure/bed/chair/comfy{
	dir = 8
	},
/obj/structure/barricade/handrail/wire{
	dir = 4;
	pixel_x = -3
	},
/obj/effect/decal/siding{
	icon_state = "siding4"
	},
/turf/open/floor/prison/red/southwest,
/area/prisonru/station/hallway/entrance)
"wm" = (
/turf/open/floor/prison,
/area/prisonru/lz/near_lzI)
"wn" = (
/obj/item/ammo_casing/bullet,
/turf/open/floor/prison,
/area/prisonru/station/hallway/entrance)
"wp" = (
/obj/structure/machinery/alarm{
	pixel_y = 24
	},
/turf/open/floor/prison/floor_plate/southwest,
/area/prisonru/station/hallway/entrance)
"wr" = (
/obj/structure/barricade/handrail/wire{
	pixel_y = 2
	},
/turf/open/floor/prison,
/area/prisonru/station/hallway/entrance)
"wJ" = (
/obj/structure/bed/chair/comfy{
	dir = 8
	},
/obj/structure/barricade/handrail/wire{
	dir = 4;
	pixel_x = -3
	},
/obj/effect/decal/siding{
	icon_state = "siding4"
	},
/turf/open/floor/prison/red/northwest,
/area/prisonru/station/hallway/entrance)
"xo" = (
/obj/structure/window/framed/prison/reinforced,
/turf/open/floor/plating/prison,
/area/prisonru/station/hallway/entrance)
"xq" = (
/obj/item/ammo_casing/bullet,
/turf/open/floor/plating/plating_catwalk/prison,
/area/prisonru/station/hallway/entrance)
"xu" = (
/obj/structure/barricade/handrail/wire{
	dir = 1;
	pixel_y = 13
	},
/obj/effect/decal/siding,
/turf/open/floor/prison,
/area/prisonru/station/hallway/entrance)
"xz" = (
/turf/closed/wall/r_wall/prison,
/area/prisonru/station/hallway/entrance)
"xK" = (
/obj/effect/decal/siding{
	icon_state = "siding4"
	},
/obj/structure/barricade/handrail/wire{
	dir = 4;
	pixel_x = -3
	},
/turf/open/floor/prison,
/area/prisonru/station/hallway/entrance)
"yq" = (
/obj/structure/pipes/vents/pump{
	dir = 8
	},
/obj/effect/decal/siding{
	icon_state = "siding4"
	},
/obj/item/stack/rods,
/obj/structure/barricade/handrail/wire{
	dir = 4;
	pixel_x = -3
	},
/turf/open/floor/prison,
/area/prisonru/station/hallway/entrance)
"zs" = (
/obj/structure/machinery/vending/cola,
/turf/open/floor/prison,
/area/prisonru/station/hallway/entrance)
"zv" = (
/obj/structure/pipes/standard/simple/hidden/dark{
	dir = 4
	},
/obj/effect/decal/cleanable/blood/drip,
/turf/open/floor/plating/plating_catwalk/prison,
/area/prisonru/station/hallway/entrance)
"zP" = (
/obj/effect/decal/cleanable/dirt,
/turf/open/floor/prison,
/area/prisonru/station/hallway/entrance)
"Ad" = (
/obj/effect/decal/siding{
	icon_state = "siding4"
	},
/obj/item/stack/rods,
/obj/structure/barricade/handrail/wire{
	dir = 4;
	pixel_x = -3
	},
/turf/open/floor/prison,
/area/prisonru/station/hallway/entrance)
"Ai" = (
/obj/structure/bed/chair/comfy{
	dir = 4
	},
/turf/open/floor/prison/floor_plate/southwest,
/area/prisonru/station/hallway/entrance)
"Ao" = (
/obj/structure/bed/chair/comfy{
	dir = 4
	},
/obj/item/trash/burger{
	pixel_y = 12;
	pixel_x = -8
	},
/obj/structure/machinery/light/double/blue{
	dir = 8;
	pixel_x = -10
	},
/turf/open/floor/prison/floor_plate/southwest,
/area/prisonru/station/hallway/entrance)
"AX" = (
/obj/effect/decal/cleanable/dirt,
/obj/item/stack/rods,
/obj/structure/barricade/handrail/type_b{
	layer = 3.4
	},
/turf/open/floor/prison,
/area/prisonru/station/hallway/entrance)
"BH" = (
/obj/structure/surface/table/almayer{
	color = "#EBD9B7"
	},
/turf/open/floor/prison,
/area/prisonru/station/security/barracks)
"Ca" = (
/obj/structure/machinery/door/airlock/multi_tile/almayer/generic{
	dir = 2;
	name = "Entrance Hallway"
	},
/turf/open/floor/prison,
/area/prisonru/lz/near_lzI)
"Cj" = (
/obj/effect/decal/cleanable/dirt,
/turf/open/floor/plating/plating_catwalk/prison,
/area/prisonru/station/hallway/entrance)
"Cz" = (
/obj/structure/pipes/standard/simple/hidden/dark,
/turf/open/floor/prison,
/area/prisonru/station/hallway/entrance)
"CR" = (
/obj/structure/pipes/standard/simple/hidden/dark,
/obj/structure/disposalpipe/segment,
/turf/open/floor/plating/plating_catwalk/prison,
/area/prisonru/station/hallway/entrance)
"Da" = (
/obj/structure/machinery/door/airlock/multi_tile/almayer/comdoor/colony{
	name = "East Hallway"
	},
/turf/open/floor/prison,
/area/prisonru/station/hallway/entrance)
"Dv" = (
/obj/effect/decal/cleanable/blood,
/turf/open/floor/prison,
/area/prisonru/station/hallway/entrance)
"Dz" = (
/obj/structure/bed/chair,
/turf/open/floor/prison/floor_plate/southwest,
/area/prisonru/station/hallway/entrance)
"DK" = (
/obj/structure/bed/chair/comfy{
	dir = 4
	},
/obj/structure/machinery/light/double/blue{
	dir = 8;
	pixel_x = -10
	},
/turf/open/floor/prison/floor_plate/southwest,
/area/prisonru/station/hallway/entrance)
"Em" = (
/obj/structure/prop/invuln/lattice_prop,
/turf/open/space/basic,
/area/prisonru/oob)
"Ex" = (
/obj/effect/landmark/hunter_secondary,
/turf/open/floor/plating/plating_catwalk/prison,
/area/prisonru/station/hallway/entrance)
"EA" = (
/turf/closed/wall/r_wall/prison_unmeltable,
/area/prisonru/station/security/barracks)
"EH" = (
/obj/item/prop/colony/used_flare,
/turf/open/floor/plating/plating_catwalk/prison,
/area/prisonru/station/hallway/entrance)
"EZ" = (
/obj/structure/pipes/standard/simple/hidden/dark{
	dir = 5
	},
/obj/structure/disposalpipe/junction{
	dir = 4;
	icon_state = "pipe-y"
	},
/turf/open/floor/plating/plating_catwalk/prison,
/area/prisonru/station/hallway/entrance)
"Fq" = (
/obj/structure/pipes/vents/pump{
	dir = 8
	},
/turf/open/floor/prison,
/area/prisonru/station/security/barracks)
"FI" = (
/obj/structure/barricade/handrail/type_b{
	dir = 1;
	pixel_y = 13
	},
/turf/open/floor/prison,
/area/prisonru/station/hallway/entrance)
"FP" = (
/obj/item/trash/cigbutt,
/turf/open/floor/plating/plating_catwalk/prison,
/area/prisonru/station/hallway/entrance)
"FU" = (
/turf/closed/wall/r_wall/prison_unmeltable,
/area/prisonru/station/command/quarters)
"HW" = (
/obj/structure/pipes/standard/simple/hidden/dark{
	dir = 4
	},
/turf/open/floor/prison,
/area/prisonru/lz/near_lzI)
"IT" = (
/obj/structure/pipes/standard/simple/hidden/dark{
	dir = 4
	},
/obj/structure/disposalpipe/segment{
	dir = 4
	},
/turf/open/floor/plating/plating_catwalk/prison,
/area/prisonru/station/hallway/entrance)
"KD" = (
/obj/structure/barricade/handrail/type_b{
	dir = 1;
	pixel_y = 13
	},
/obj/structure/flora/pottedplant{
	icon_state = "pottedplant_21"
	},
/turf/open/floor/prison,
/area/prisonru/station/hallway/entrance)
"KG" = (
/obj/structure/pipes/standard/simple/hidden/dark{
	dir = 4
	},
/obj/effect/decal/cleanable/dirt,
/turf/open/floor/plating/plating_catwalk/prison,
/area/prisonru/station/hallway/entrance)
"La" = (
/obj/structure/pipes/standard/simple/hidden/dark{
	dir = 10
	},
/obj/structure/disposalpipe/segment{
	dir = 2;
	icon_state = "pipe-c"
	},
/turf/open/floor/prison,
/area/prisonru/station/hallway/entrance)
"Ld" = (
/turf/open/floor/prison,
/area/prisonru/station/hallway/entrance)
"Ll" = (
/obj/item/ammo_casing/bullet,
/obj/structure/barricade/handrail/wire{
	dir = 4;
	pixel_x = -3
	},
/obj/effect/decal/siding{
	icon_state = "siding4"
	},
/turf/open/floor/prison,
/area/prisonru/station/hallway/entrance)
"Lv" = (
/obj/structure/disposalpipe/segment,
/obj/structure/pipes/standard/simple/hidden/dark,
/turf/open/floor/plating/plating_catwalk/prison,
/area/prisonru/station/hallway/entrance)
"LJ" = (
/turf/closed/wall/r_wall/prison,
/area/prisonru/station/security/barracks)
"Mc" = (
/obj/structure/bed/chair/comfy{
	dir = 4
	},
/turf/open/floor/prison/red/southeast,
/area/prisonru/station/hallway/entrance)
"Mr" = (
/obj/structure/pipes/standard/simple/hidden/dark,
/obj/structure/disposalpipe/segment,
/obj/item/trash/cigbutt,
/turf/open/floor/plating/plating_catwalk/prison,
/area/prisonru/station/hallway/entrance)
"MA" = (
/obj/item/trash/candle,
/obj/structure/surface/table/reinforced/prison{
	dir = 1;
	color = "#8e98a0"
	},
/turf/open/floor/prison/redfull,
/area/prisonru/station/hallway/entrance)
"Ni" = (
/obj/structure/pipes/standard/simple/hidden/dark{
	dir = 4
	},
/obj/structure/machinery/door/airlock/multi_tile/almayer/generic{
	dir = 2;
	name = "Entrance Hallway"
	},
/turf/open/floor/prison,
/area/prisonru/lz/near_lzI)
"Np" = (
/turf/open/floor/prison/floor_plate/southwest,
/area/prisonru/station/hallway/entrance)
"NG" = (
/obj/effect/landmark/hunter_primary,
/turf/open/floor/plating/plating_catwalk/prison,
/area/prisonru/station/hallway/entrance)
"Or" = (
/obj/structure/pipes/standard/simple/hidden/dark{
	dir = 4
	},
/obj/item/prop/colony/used_flare,
/turf/open/floor/plating/plating_catwalk/prison,
/area/prisonru/station/hallway/entrance)
"OG" = (
/obj/item/stack/rods,
/turf/open/floor/plating/plating_catwalk/prison,
/area/prisonru/station/hallway/entrance)
"OM" = (
/obj/structure/pipes/standard/manifold/hidden/dark,
/turf/open/floor/prison,
/area/prisonru/station/hallway/entrance)
"OQ" = (
/turf/open/floor/prison,
/area/prisonru/station/security/barracks)
"Pp" = (
/obj/structure/barricade/handrail/wire{
	dir = 4;
	pixel_x = -3
	},
/obj/effect/decal/siding{
	icon_state = "siding4"
	},
/turf/open/floor/prison,
/area/prisonru/station/hallway/entrance)
"Qw" = (
/turf/closed/wall/prison,
/area/prisonru/station/recreation/staff)
"QX" = (
/obj/item/ammo_casing/bullet,
/obj/effect/decal/cleanable/dirt,
/turf/open/floor/prison,
/area/prisonru/station/hallway/entrance)
"Ry" = (
/turf/open_space,
/area/prisonru/oob)
"RP" = (
/obj/effect/decal/warning_stripes{
	icon_state = "W"
	},
/turf/open/floor/prison/floor_plate/southwest,
/area/prisonru/station/hallway/entrance)
"RT" = (
/obj/effect/decal/cleanable/dirt,
/obj/structure/barricade/handrail/wire{
	dir = 1;
	pixel_y = 13
	},
/obj/effect/decal/siding,
/turf/open/floor/prison,
/area/prisonru/station/hallway/entrance)
"Sk" = (
/obj/structure/bed/chair/comfy{
	dir = 4
	},
/turf/open/floor/prison/red/northeast,
/area/prisonru/station/hallway/entrance)
"SC" = (
/obj/structure/pipes/vents/scrubber{
	dir = 4
	},
/obj/effect/decal/warning_stripes{
	icon_state = "W"
	},
/turf/open/floor/prison/floor_plate/southwest,
/area/prisonru/station/hallway/entrance)
"SM" = (
/obj/item/stack/sheet/metal{
	pixel_x = -2;
	pixel_y = 3
	},
/obj/structure/bedsheetbin{
	icon_state = "linenbin-empty";
	pixel_x = 8
	},
/obj/item/reagent_container/glass/rag{
	desc = "A towel for drying yourself.";
	icon = 'icons/obj/items/hunter/pred_gear.dmi';
	icon_state = "polishing_rag";
	name = "towel";
	pixel_x = 8
	},
/obj/item/tool/mop{
	layer = 4;
	pixel_x = -6;
	pixel_y = 24
	},
/turf/open/floor/prison,
/area/prisonru/station/security/barracks)
"SX" = (
/obj/structure/barricade/handrail/type_b{
	dir = 8;
	pixel_x = -5
	},
/obj/structure/barricade/handrail/type_b{
	dir = 1;
	pixel_y = 13
	},
/obj/structure/flora/pottedplant{
	icon_state = "pottedplant_18";
	pixel_y = 12
	},
/turf/open/floor/prison,
/area/prisonru/station/hallway/entrance)
"Ti" = (
/obj/item/ammo_casing/bullet,
/obj/item/trash/burger{
	pixel_y = 12;
	pixel_x = -8
	},
/turf/open/floor/plating/plating_catwalk/prison,
/area/prisonru/station/hallway/entrance)
"TU" = (
/obj/structure/window/framed/prison/reinforced/hull,
/obj/effect/decal/siding,
/obj/structure/blocker/invisible_wall,
/turf/open/floor/plating/prison,
/area/prisonru/station/hallway/entrance)
"Ui" = (
/turf/open/space/basic,
/area/prisonru/oob)
"VS" = (
/obj/structure/machinery/camera/autoname{
	dir = 4;
	network = list("PRISON")
	},
/obj/item/ammo_casing/bullet,
/turf/open/floor/prison/floor_plate/southwest,
/area/prisonru/station/hallway/entrance)
"Wh" = (
/obj/structure/machinery/disposal{
	color = "#8e98a0"
	},
/obj/structure/window/reinforced{
	dir = 8;
	health = 80
	},
/obj/structure/disposalpipe/trunk{
	dir = 1
	},
/obj/effect/decal/cleanable/dirt,
/obj/item/trash/buritto,
/turf/open/floor/prison,
/area/prisonru/station/hallway/entrance)
"Ww" = (
/obj/structure/pipes/vents/scrubber{
	dir = 4
	},
/turf/open/floor/prison/floor_plate/southwest,
/area/prisonru/station/hallway/entrance)
"Xv" = (
/obj/structure/barricade/handrail/wire{
	dir = 1;
	pixel_y = 13
	},
/obj/structure/barricade/handrail/wire{
	dir = 4;
	pixel_x = -3
	},
/obj/effect/decal/siding,
/obj/effect/decal/siding{
	icon_state = "siding4"
	},
/turf/open/floor/prison/redfull,
/area/prisonru/station/hallway/entrance)
"XB" = (
/obj/structure/machinery/vending/snack,
/turf/open/floor/prison,
/area/prisonru/station/hallway/entrance)
"XC" = (
/obj/structure/barricade/handrail/type_b{
	layer = 3.4
	},
/turf/open/floor/prison,
/area/prisonru/station/hallway/entrance)
"XQ" = (
/obj/structure/largecrate/random/barrel/brown,
/turf/open/floor/prison/floor_plate/southwest,
/area/prisonru/station/hallway/entrance)
"XW" = (
/obj/structure/barricade/handrail/wire{
	dir = 1;
	pixel_y = 13
	},
/obj/effect/decal/siding,
/turf/open/floor/prison/redfull,
/area/prisonru/station/hallway/entrance)
"ZA" = (
/obj/item/trash/cigbutt,
/obj/structure/barricade/handrail/type_b{
	dir = 8;
	pixel_x = -5
	},
/obj/structure/barricade/handrail/type_b{
	layer = 3.4
	},
/turf/open/floor/prison,
/area/prisonru/station/hallway/entrance)
"ZX" = (
/obj/item/stack/sheet/metal{
	pixel_x = -2;
	pixel_y = 3
	},
/obj/structure/bed/hybrisa/bunkbed2{
	dir = 8
	},
/turf/open/floor/prison,
/area/prisonru/station/security/barracks)
"ZZ" = (
/obj/structure/pipes/standard/simple/hidden/dark,
/obj/structure/disposalpipe/segment,
/turf/open/floor/prison,
/area/prisonru/station/hallway/entrance)

(1,1,1) = {"
Qw
Qw
nX
Np
iU
RP
SC
RP
pw
tk
Ai
sS
VS
sh
XQ
gg
DK
Ai
Ai
Ww
Cz
OM
Ai
Ai
Ai
Ao
zs
xz
"}
(2,1,1) = {"
Qw
Dz
aB
Np
QX
Ld
fV
zP
cn
Ld
Ld
Ld
Ld
Ld
wn
Ld
Ld
cn
Ld
wn
Ld
rJ
Ld
Ld
Ld
Ld
XB
xz
"}
(3,1,1) = {"
hD
Dz
mu
ne
ex
qo
Lv
bt
CR
CR
CR
CR
Mr
CR
CR
bt
Lv
ex
bt
CR
CR
mh
ex
CR
CR
EZ
Wh
rd
"}
(4,1,1) = {"
hD
wp
xq
IT
mu
xq
OG
sW
mu
mu
sW
Ex
mu
fA
mu
sW
fA
mu
aL
xq
fA
xq
FP
Ti
mu
IT
Ld
Da
"}
(5,1,1) = {"
xo
Np
mu
IT
Ld
Ad
xK
yq
ds
Ld
KG
mu
SX
ZA
mu
sW
zP
Pp
gv
xK
Pp
Ld
Ld
wn
Ld
La
ZZ
ZZ
"}
(6,1,1) = {"
na
mu
xq
IT
wr
qM
qM
qM
qM
RT
sW
NG
FI
mA
fA
KG
wr
qM
qM
qM
qM
XW
Sk
Mc
oK
Dv
Ld
xo
"}
(7,1,1) = {"
ZZ
Lv
CR
mK
wr
qM
Ui
Ui
qM
xu
zv
fA
FI
XC
EH
mq
wr
qM
Ui
Ui
qM
pF
MA
nr
ab
lc
Ld
xz
"}
(8,1,1) = {"
xo
Pp
Pp
Ll
cu
qM
Ui
Ui
qM
xu
KG
mu
bP
XC
mu
sW
lM
qM
Ui
Ui
qM
Xv
wJ
vt
gD
LJ
LJ
LJ
"}
(9,1,1) = {"
FU
qM
qM
qM
qM
qM
Em
Em
qM
xu
KG
mu
FI
XC
Cj
zv
wr
qM
Em
Em
qM
TU
qM
qM
qM
EA
BH
ZX
"}
(10,1,1) = {"
FU
Ui
Ui
Ui
Em
Ui
Ui
Ui
qM
RT
Or
mu
KD
XC
mu
sW
wr
qM
Ui
Ui
Ui
Em
Ui
Ui
Ui
iS
OQ
dI
"}
(11,1,1) = {"
FU
Ui
Ui
Ui
Em
Ui
Ui
Ui
qM
xu
sW
mu
FI
AX
mu
sW
wr
qM
Ui
Ui
Ui
Em
Ui
Ui
Ui
EA
fo
Fq
"}
(12,1,1) = {"
FU
Em
Em
Em
ff
ff
ff
ff
pq
jn
HW
Ca
jn
jn
wm
Ni
jn
pq
ff
ff
ff
ff
Em
Em
Em
iS
SM
cp
"}

(1,1,2) = {"
Ry
Ry
Ry
Ry
Ry
Ry
Ry
Ry
Ry
Ry
Ry
Ry
Ry
Ry
Ry
Ry
Ry
Ry
Ry
Ry
Ry
Ry
Ry
Ry
Ry
Ry
Ry
Ry
"}
(2,1,2) = {"
Ry
Ry
Ry
Ry
Ry
Ry
Ry
Ry
Ry
Ry
Ry
Ry
Ry
Ry
Ry
Ry
Ry
Ry
Ry
Ry
Ry
Ry
Ry
Ry
Ry
Ry
Ry
Ry
"}
(3,1,2) = {"
Ry
Ry
Ry
Ry
Ry
Ry
Ry
Ry
Ry
Ry
Ry
Ry
Ry
Ry
Ry
Ry
Ry
Ry
Ry
Ry
Ry
Ry
Ry
Ry
Ry
Ry
Ry
Ry
"}
(4,1,2) = {"
Ry
Ry
Ry
Ry
Ry
Ry
Ry
Ry
Ry
Ry
Ry
Ry
Ry
Ry
Ry
Ry
Ry
Ry
Ry
Ry
Ry
Ry
Ry
Ry
Ry
Ry
Ry
Ry
"}
(5,1,2) = {"
Ry
Ry
Ry
Ry
Ry
Ry
Ry
Ry
Ry
Ry
Ry
Ry
Ry
Ry
Ry
Ry
Ry
Ry
Ry
Ry
Ry
Ry
Ry
Ry
Ry
Ry
Ry
Ry
"}
(6,1,2) = {"
Ry
Ry
Ry
Ry
Ry
aa
aa
aa
aa
Ry
Ry
Ry
Ry
Ry
Ry
Ry
Ry
aa
aa
aa
aa
Ry
Ry
Ry
Ry
Ry
Ry
Ry
"}
(7,1,2) = {"
Ry
Ry
Ry
Ry
Ry
aa
Ry
Ry
aa
Ry
Ry
Ry
Ry
Ry
Ry
Ry
Ry
aa
Ry
Ry
aa
Ry
Ry
Ry
Ry
Ry
Ry
Ry
"}
(8,1,2) = {"
Ry
Ry
Ry
Ry
Ry
aa
Ry
Ry
aa
Ry
Ry
Ry
Ry
Ry
Ry
Ry
Ry
aa
Ry
Ry
aa
Ry
Ry
Ry
Ry
Ry
Ry
Ry
"}
(9,1,2) = {"
aa
aa
aa
aa
aa
aa
Ry
Ry
aa
Ry
Ry
Ry
Ry
Ry
Ry
Ry
Ry
aa
Ry
Ry
aa
aa
aa
aa
aa
aa
Ry
Ry
"}
(10,1,2) = {"
aa
Ry
Ry
Ry
Ry
Ry
Ry
Ry
aa
Ry
Ry
Ry
Ry
Ry
Ry
Ry
Ry
aa
Ry
Ry
Ry
Ry
Ry
Ry
Ry
aa
Ry
Ry
"}
(11,1,2) = {"
aa
Ry
Ry
Ry
Ry
Ry
Ry
Ry
aa
Ry
Ry
Ry
Ry
Ry
Ry
Ry
Ry
aa
Ry
Ry
Ry
Ry
Ry
Ry
Ry
aa
Ry
Ry
"}
(12,1,2) = {"
aa
Ry
Ry
Ry
aa
aa
aa
aa
aa
Ry
Ry
Ry
Ry
Ry
Ry
Ry
Ry
aa
aa
aa
aa
aa
Ry
Ry
Ry
aa
Ry
Ry
"}
