//MAP CONVERTED BY dmm2tgm.py THIS HEADER COMMENT PREVENTS RECONVERSION, DO NOT REMOVE
"aN" = (
/obj/structure/machinery/big_computers/science_big/operator_machine,
/obj/structure/window/reinforced{
	dir = 1;
	layer = 2
	},
/turf/open/floor/almayer/blackfull/west,
/area/prison/research/secret/testing)
"aT" = (
/obj/structure/cable/white{
	color = "#550d0d";
	icon_state = "5-6";
	layer = 5;
	level = 2
	},
/mob/living/simple_animal/mouse/rat/white/Milky,
/turf/open/floor/hybrisa/misc/wysmallright,
/area/prison/research/secret/testing)
"bJ" = (
/obj/effect/decal/warning_stripes{
	icon_state = "N";
	pixel_y = 2
	},
/obj/effect/decal/warning_stripes{
	icon_state = "S"
	},
/obj/item/clothing/glasses/science,
/turf/open/floor/hybrisa/tile/tilewhite,
/area/prison/research/secret/testing)
"bZ" = (
/obj/structure/prop/hybrisa/xenobiology/small/hugger,
/turf/open/floor/almayer/blackfull/west,
/area/prison/research/secret/testing)
"el" = (
/obj/structure/machinery/big_computers/computerwhite/computer4,
/obj/structure/window/reinforced{
	dir = 8
	},
/obj/structure/window/reinforced{
	dir = 1;
	layer = 2
	},
/turf/open/floor/almayer/blackfull/west,
/area/prison/research/secret/testing)
"ev" = (
/obj/item/paper/crumpled{
	pixel_x = 15;
	pixel_y = -9
	},
/obj/effect/decal/cleanable/blood,
/turf/open/floor/hybrisa/misc/wysmallleft,
/area/prison/research/secret/testing)
"go" = (
/obj/structure/surface/table/reinforced/prison,
/obj/structure/machinery/centrifuge{
	pixel_y = 8;
	pixel_x = -2
	},
/obj/structure/machinery/light/small/blue{
	dir = 1
	},
/obj/structure/sign/poster/corporate{
	pixel_y = 32
	},
/turf/open/floor/almayer/blackfull/west,
/area/prison/research/secret/testing)
"ho" = (
/obj/structure/machinery/autodispenser,
/turf/open/floor/almayer/blackfull/west,
/area/prison/research/secret/testing)
"iw" = (
/obj/effect/decal/warning_stripes{
	icon_state = "N";
	pixel_y = 2
	},
/obj/effect/decal/warning_stripes{
	icon_state = "S"
	},
/turf/open/floor/hybrisa/tile/tilewhite,
/area/prison/research/secret/testing)
"jf" = (
/obj/item/tool/kitchen/tray{
	pixel_y = 8
	},
/obj/item/weed_extract{
	pixel_y = 6
	},
/obj/item/weed_extract{
	pixel_x = 6;
	pixel_y = 8
	},
/obj/item/weed_extract{
	pixel_x = -6;
	pixel_y = 7
	},
/obj/structure/platform/metal/almayer/north{
	layer = 1.9
	},
/obj/structure/surface/table/reinforced/prison,
/obj/structure/window/reinforced,
/turf/open/floor/almayer/blackfull/west,
/area/prison/research/secret/testing)
"jv" = (
/turf/open/space/basic,
/area/space)
"kg" = (
/obj/effect/decal/warning_stripes{
	icon_state = "E";
	layer = 3.33
	},
/obj/effect/decal/warning_stripes{
	icon_state = "W"
	},
/obj/item/shard,
/turf/open/floor/hybrisa/tile/tilewhite,
/area/prison/research/secret/testing)
"kz" = (
/obj/effect/decal/warning_stripes{
	icon_state = "E";
	layer = 3.33
	},
/obj/effect/decal/warning_stripes{
	icon_state = "W"
	},
/obj/effect/decal/strata_decals/grime/grime4{
	dir = 4
	},
/turf/open/floor/hybrisa/tile/tilewhite,
/area/prison/research/secret/testing)
"lv" = (
/obj/structure/surface/table/reinforced/prison,
/obj/item/paper_bin{
	pixel_x = -3;
	pixel_y = 9
	},
/obj/item/paper/crumpled{
	pixel_x = 15;
	pixel_y = -9
	},
/obj/item/tool/stamp/rd,
/obj/item/tool/pen{
	pixel_x = -4;
	pixel_y = 6
	},
/obj/effect/spawner/random/goggles/lowchance,
/turf/open/floor/almayer/blackfull/west,
/area/prison/research/secret/testing)
"lI" = (
/obj/effect/decal/warning_stripes{
	icon_state = "N";
	pixel_y = 2
	},
/obj/effect/decal/warning_stripes{
	icon_state = "S"
	},
/obj/structure/cable/white{
	color = "#007740";
	icon_state = "8-9";
	layer = 5;
	level = 2
	},
/turf/open/floor/hybrisa/tile/tilewhite,
/area/prison/research/secret/testing)
"md" = (
/obj/structure/window/reinforced,
/turf/open/floor/almayer/blackfull/west,
/area/prison/research/secret/testing)
"ne" = (
/obj/structure/window/framed/prison/reinforced,
/obj/structure/machinery/door/poddoor/almayer/biohazard/white{
	icon = 'icons/obj/structures/doors/hybrisashutters.dmi';
	id = "fiorina_wy_labs_lockdown"
	},
/turf/open/floor/plating/prison,
/area/prison/research/secret/testing)
"ow" = (
/obj/structure/machinery/big_computers/science_big/synthesis_simulator,
/obj/structure/window/reinforced,
/obj/structure/window/reinforced{
	dir = 8
	},
/turf/open/floor/almayer/blackfull/west,
/area/prison/research/secret/testing)
"pD" = (
/obj/effect/decal/warning_stripes{
	icon_state = "W"
	},
/obj/effect/decal/warning_stripes{
	icon_state = "N";
	pixel_y = 2
	},
/obj/item/shard,
/obj/item/prop/alien/hugger{
	pixel_x = -7;
	pixel_y = -5
	},
/obj/item/clothing/head/bio_hood/wy_bio/alt,
/turf/open/floor/hybrisa/tile/tilewhite,
/area/prison/research/secret/testing)
"qj" = (
/turf/closed/wall/r_wall/prison_unmeltable,
/area/space)
"rr" = (
/obj/structure/machinery/computer/disk_reader{
	dir = 8
	},
/obj/structure/surface/table/reinforced/prison,
/obj/structure/machinery/door_control{
	pixel_y = 11;
	pixel_x = -7;
	id = "fiorina_wy_labs_lockdown"
	},
/turf/open/floor/almayer/blackfull/west,
/area/prison/research/secret/testing)
"rT" = (
/obj/structure/window/reinforced,
/obj/structure/window/reinforced{
	dir = 4
	},
/turf/open/floor/almayer/blackfull/west,
/area/prison/research/secret/testing)
"ug" = (
/obj/effect/decal/warning_stripes{
	icon_state = "S"
	},
/turf/open/floor/prison/whitered/north,
/area/prison/research/secret/testing)
"ut" = (
/turf/open/floor/almayer/blackfull/west,
/area/prison/research/secret/testing)
"ux" = (
/obj/structure/cable/white{
	color = "#9f8700";
	icon_state = "8-9";
	layer = 5;
	level = 2
	},
/obj/effect/decal/warning_stripes{
	icon_state = "N";
	pixel_y = 2
	},
/obj/effect/decal/warning_stripes{
	icon_state = "S"
	},
/turf/open/floor/hybrisa/tile/tilewhite,
/area/prison/research/secret/testing)
"uV" = (
/obj/structure/cable/white{
	color = "#550d0d";
	icon_state = "8-10";
	layer = 5;
	level = 2
	},
/obj/structure/window/reinforced{
	dir = 4
	},
/obj/structure/window/reinforced{
	dir = 1;
	layer = 2
	},
/obj/structure/prop/hybrisa/xenobiology/small/larva,
/turf/open/floor/almayer/blackfull/west,
/area/prison/research/secret/testing)
"vE" = (
/obj/structure/cable/white{
	color = "#9f8700";
	icon_state = "4-6";
	layer = 5;
	level = 2
	},
/obj/effect/decal/warning_stripes{
	icon_state = "N";
	pixel_y = 2
	},
/obj/effect/decal/warning_stripes{
	icon_state = "S"
	},
/turf/open/floor/hybrisa/tile/tilewhite,
/area/prison/research/secret/testing)
"wg" = (
/obj/effect/decal/warning_stripes{
	icon_state = "N";
	pixel_y = 2
	},
/obj/effect/decal/warning_stripes{
	icon_state = "S"
	},
/obj/effect/decal/strata_decals/grime/grime4{
	dir = 4
	},
/turf/open/floor/hybrisa/tile/tilewhite,
/area/prison/research/secret/testing)
"ws" = (
/obj/structure/machinery/big_computers/science_big/medilathe,
/obj/structure/window/reinforced,
/turf/open/floor/almayer/blackfull/west,
/area/prison/research/secret/testing)
"xX" = (
/obj/effect/decal/warning_stripes{
	icon_state = "N";
	pixel_y = 2
	},
/obj/effect/decal/warning_stripes{
	icon_state = "E";
	layer = 3.33
	},
/turf/open/floor/hybrisa/tile/tilewhite,
/area/prison/research/secret/testing)
"yp" = (
/obj/effect/decal/warning_stripes{
	icon_state = "N";
	pixel_y = 2
	},
/obj/effect/decal/warning_stripes{
	icon_state = "S"
	},
/obj/structure/cable/white{
	color = "#007740";
	icon_state = "1-4";
	layer = 5;
	level = 2
	},
/turf/open/floor/hybrisa/tile/tilewhite,
/area/prison/research/secret/testing)
"zo" = (
/obj/effect/decal/warning_stripes{
	icon_state = "S"
	},
/obj/effect/decal/hybrisa/workers_decal{
	pixel_x = 1;
	color = "#32332d";
	pixel_y = 1
	},
/turf/open/floor/prison/whitered/north,
/area/prison/research/secret/testing)
"AG" = (
/obj/effect/decal/strata_decals/grime/grime4{
	dir = 4
	},
/turf/open/floor/almayer/blackfull/west,
/area/prison/research/secret/testing)
"BM" = (
/obj/structure/prop/hybrisa/xenobiology/small/offempty,
/turf/open/floor/almayer/blackfull/west,
/area/prison/research/secret/testing)
"Cm" = (
/obj/structure/machinery/big_computers/computerwhite/computer3,
/turf/open/floor/almayer/blackfull/west,
/area/prison/research/secret/testing)
"Cu" = (
/obj/effect/decal/warning_stripes{
	icon_state = "W"
	},
/obj/effect/decal/warning_stripes{
	icon_state = "E";
	layer = 3.33
	},
/obj/structure/bed/chair/office/dark{
	dir = 4;
	pixel_x = 7;
	pixel_y = 10
	},
/turf/open/floor/hybrisa/tile/tilewhite,
/area/prison/research/secret/testing)
"CV" = (
/obj/effect/decal/warning_stripes{
	icon_state = "N"
	},
/obj/structure/machinery/door/airlock/multi_tile/hybrisa/personal_solid_white/autoname,
/obj/structure/machinery/door/poddoor/almayer/biohazard/white{
	icon = 'icons/obj/structures/doors/hybrisashutters.dmi';
	id = "fiorina_wy_labs_lockdown"
	},
/turf/open/floor/plating/prison,
/area/prison/research/secret/testing)
"Df" = (
/obj/effect/decal/warning_stripes{
	icon_state = "N";
	pixel_y = 2
	},
/obj/effect/decal/warning_stripes{
	icon_state = "S"
	},
/obj/effect/decal/strata_decals/grime/grime4{
	dir = 4
	},
/obj/item/shard,
/turf/open/floor/hybrisa/tile/tilewhite,
/area/prison/research/secret/testing)
"DZ" = (
/turf/open_space,
/area/space)
"Fp" = (
/obj/structure/prop/hybrisa/xenobiology/small/larva,
/turf/open/floor/almayer/blackfull/west,
/area/prison/research/secret/testing)
"FX" = (
/obj/structure/surface/table/reinforced/prison,
/obj/item/clipboard,
/obj/item/paper,
/obj/item/paper{
	layer = 5;
	pixel_x = -7;
	pixel_y = 7
	},
/obj/effect/landmark/objective_landmark/science,
/turf/open/floor/almayer/blackfull/west,
/area/prison/research/secret/testing)
"GQ" = (
/turf/closed/wall/r_wall/prison_unmeltable,
/area/prison/research/secret/testing)
"GV" = (
/obj/effect/decal/warning_stripes{
	icon_state = "N"
	},
/obj/structure/machinery/door/poddoor/almayer/biohazard/white{
	icon = 'icons/obj/structures/doors/hybrisashutters.dmi';
	id = "fiorina_wy_labs_lockdown"
	},
/turf/open/floor/plating/prison,
/area/prison/research/secret/testing)
"Ha" = (
/obj/structure/surface/table/reinforced/prison,
/obj/structure/machinery/reagent_analyzer{
	pixel_y = 6
	},
/obj/structure/prop/hybrisa/misc/metergreen{
	pixel_y = 36
	},
/turf/open/floor/almayer/blackfull/west,
/area/prison/research/secret/testing)
"Ie" = (
/turf/open/space,
/area/space)
"Jt" = (
/obj/effect/decal/warning_stripes{
	icon_state = "W"
	},
/obj/effect/decal/warning_stripes{
	icon_state = "S"
	},
/obj/effect/decal/cleanable/blood,
/turf/open/floor/hybrisa/tile/tilewhite,
/area/prison/research/secret/testing)
"LB" = (
/obj/structure/machinery/big_computers/science_big/protolathe,
/obj/structure/prop/hybrisa/misc/redmeter{
	pixel_y = 32
	},
/turf/open/floor/almayer/blackfull/west,
/area/prison/research/secret/testing)
"Mh" = (
/obj/structure/reagent_dispensers/watertank,
/obj/effect/decal/warning_stripes{
	icon_state = "S"
	},
/turf/open/floor/prison/whitered/northeast,
/area/prison/research/secret/testing)
"Mw" = (
/obj/item/tool/kitchen/tray,
/obj/item/stack/sheet/xenochitin{
	pixel_y = 12
	},
/obj/item/tool/kitchen/tray{
	pixel_y = 13
	},
/obj/structure/surface/table/reinforced/prison,
/obj/item/stack/sheet/xenochitin,
/turf/open/floor/almayer/blackfull/west,
/area/prison/research/secret/testing)
"Os" = (
/obj/effect/decal/warning_stripes{
	icon_state = "E";
	layer = 3.33
	},
/obj/effect/decal/warning_stripes{
	icon_state = "W"
	},
/turf/open/floor/hybrisa/tile/tilewhite,
/area/prison/research/secret/testing)
"Rg" = (
/obj/effect/decal/warning_stripes{
	icon_state = "S"
	},
/obj/effect/decal/warning_stripes{
	icon_state = "W"
	},
/obj/structure/machinery/light/double/blue{
	dir = 8;
	pixel_x = -10
	},
/turf/open/floor/prison/whitered/northwest,
/area/prison/research/secret/testing)
"Ry" = (
/obj/structure/machinery/light/small/blue{
	dir = 1
	},
/obj/effect/decal/strata_decals/grime/grime4{
	dir = 4
	},
/obj/effect/landmark/objective_landmark/science,
/obj/structure/sign/poster/wylogo{
	pixel_y = 32;
	layer = 2.9
	},
/obj/structure/prop/hybrisa/xenobiology/small/cracked1,
/obj/item/shard,
/turf/open/floor/almayer/blackfull/west,
/area/prison/research/secret/testing)
"Wq" = (
/obj/structure/surface/table/reinforced/prison,
/obj/structure/machinery/r_n_d/organic_analyzer{
	pixel_y = 9;
	pixel_x = -3
	},
/turf/open/floor/almayer/blackfull/west,
/area/prison/research/secret/testing)
"XY" = (
/obj/effect/decal/warning_stripes{
	icon_state = "E";
	layer = 3.33
	},
/obj/effect/decal/warning_stripes{
	icon_state = "S"
	},
/obj/item/paper/crumpled{
	pixel_x = 15;
	pixel_y = -9
	},
/turf/open/floor/hybrisa/tile/tilewhite,
/area/prison/research/secret/testing)
"Yk" = (
/obj/structure/cable/white{
	color = "#9f8700";
	icon_state = "8-9";
	layer = 5;
	level = 2
	},
/obj/effect/spawner/random/pills/highchance,
/obj/structure/window/reinforced{
	dir = 1;
	layer = 2
	},
/turf/open/floor/almayer/blackfull/west,
/area/prison/research/secret/testing)

(1,1,1) = {"
Ie
GQ
GQ
GQ
GQ
GQ
GQ
GQ
GQ
"}
(2,1,1) = {"
GQ
GQ
Ry
BM
bZ
Fp
BM
ne
Rg
"}
(3,1,1) = {"
GQ
Cm
pD
kg
Os
Os
Jt
ne
ug
"}
(4,1,1) = {"
GQ
LB
Df
el
AG
ow
bJ
ne
ug
"}
(5,1,1) = {"
GQ
ut
vE
aN
ev
md
yp
CV
zo
"}
(6,1,1) = {"
GQ
Wq
ux
Yk
aT
ws
lI
GV
ug
"}
(7,1,1) = {"
GQ
Ha
iw
uV
ut
rT
wg
ne
ug
"}
(8,1,1) = {"
GQ
go
xX
kz
Os
Cu
XY
ne
ug
"}
(9,1,1) = {"
GQ
ho
Mw
jf
lv
rr
FX
ne
Mh
"}

(1,1,2) = {"
jv
DZ
qj
qj
qj
qj
qj
qj
qj
"}
(2,1,2) = {"
jv
qj
qj
qj
qj
qj
qj
qj
qj
"}
(3,1,2) = {"
jv
qj
qj
qj
qj
qj
qj
qj
qj
"}
(4,1,2) = {"
jv
qj
qj
qj
qj
qj
qj
qj
qj
"}
(5,1,2) = {"
jv
qj
qj
qj
qj
qj
qj
qj
qj
"}
(6,1,2) = {"
jv
qj
qj
qj
qj
qj
qj
qj
qj
"}
(7,1,2) = {"
jv
qj
qj
qj
qj
qj
qj
qj
qj
"}
(8,1,2) = {"
jv
qj
qj
qj
qj
qj
qj
qj
qj
"}
(9,1,2) = {"
jv
qj
qj
qj
qj
qj
qj
qj
qj
"}
