//MAP CONVERTED BY dmm2tgm.py THIS HEADER COMMENT PREVENTS RECONVERSION, DO NOT REMOVE
"a" = (
/turf/open/floor/prison/red/east,
/area/prisonru/cellblock/highsec/south/south)
"c" = (
/obj/structure/machinery/light/double/blue,
/turf/open/floor/prison/red/southeast,
/area/prisonru/cellblock/highsec/south/south)
"d" = (
/obj/structure/pipes/standard/simple/hidden/dark,
/obj/structure/machinery/door/airlock/prison_hatch/autoname{
	dir = 1
	},
/turf/open/floor/plating/prison,
/area/prisonru/station/maintenance/hi/south_sec_maint)
"e" = (
/turf/open/floor/prison/red/southwest,
/area/prisonru/cellblock/highsec/south/south)
"g" = (
/obj/structure/sign/safety/maint{
	pixel_x = 15;
	pixel_y = -8
	},
/turf/closed/wall/prison,
/area/prisonru/station/maintenance/hi/south_sec_maint)
"k" = (
/obj/item/explosive/grenade/incendiary/molotov,
/turf/open/floor/prison/damaged2/southwest,
/area/prisonru/cellblock/highsec/south/south)
"m" = (
/turf/open/floor/prison/damaged2/southwest,
/area/prisonru/cellblock/highsec/south/south)
"n" = (
/turf/open/floor/prison/floor_plate/southwest,
/area/prisonru/cellblock/highsec/south/south)
"o" = (
/obj/structure/machinery/light/small/blue{
	dir = 8
	},
/turf/open/floor/plating/prison,
/area/prisonru/station/maintenance/hi/south_sec_maint)
"p" = (
/obj/structure/pipes/standard/simple/hidden/dark,
/obj/effect/decal/cleanable/dirt,
/turf/open/floor/plating/prison,
/area/prisonru/station/maintenance/hi/south_sec_maint)
"q" = (
/obj/structure/pipes/standard/simple/hidden/dark{
	dir = 6
	},
/turf/open/floor/prison/damaged2/southwest,
/area/prisonru/station/maintenance/hi/south_sec_maint)
"v" = (
/turf/open/floor/plating/prison,
/area/prisonru/station/maintenance/hi/south_sec_maint)
"w" = (
/obj/structure/pipes/standard/simple/hidden/dark,
/turf/open/floor/plating/prison,
/area/prisonru/station/maintenance/hi/south_sec_maint)
"x" = (
/obj/structure/largecrate/random,
/turf/open/floor/plating/prison,
/area/prisonru/station/maintenance/hi/south_sec_maint)
"y" = (
/obj/structure/pipes/standard/simple/hidden/dark,
/obj/item/stack/rods,
/turf/open/floor/prison/damaged2/southwest,
/area/prisonru/station/maintenance/hi/south_sec_maint)
"z" = (
/obj/item/stack/rods,
/turf/open/floor/prison/floor_plate/southwest,
/area/prisonru/cellblock/highsec/south/south)
"C" = (
/obj/item/stack/sheet/metal,
/turf/open/floor/prison/floor_plate/southwest,
/area/prisonru/cellblock/highsec/south/south)
"J" = (
/turf/closed/wall/prison,
/area/prisonru/station/maintenance/hi/south_sec_maint)
"L" = (
/turf/open_space,
/area/space)
"M" = (
/turf/open/floor/prison/damaged2/southwest,
/area/prisonru/station/maintenance/hi/south_sec_maint)
"P" = (
/obj/effect/decal/cleanable/dirt,
/obj/effect/decal/cleanable/dirt,
/obj/item/stack/sheet/metal,
/turf/open/floor/plating/prison,
/area/prisonru/station/maintenance/hi/south_sec_maint)
"Q" = (
/turf/closed/wall/r_wall/prison_unmeltable,
/area/prisonru/station/maintenance/hi/south_sec_maint)
"S" = (
/obj/structure/surface/rack{
	color = "#8e98a0"
	},
/obj/item/stack/rods,
/obj/item/stack/rods,
/obj/item/stack/rods,
/obj/item/stack/rods,
/turf/open/floor/plating/prison,
/area/prisonru/station/maintenance/hi/south_sec_maint)
"U" = (
/turf/closed/wall/r_wall/prison_unmeltable,
/area/space)
"V" = (
/turf/closed/wall/r_wall/prison_unmeltable,
/area/prisonru/cellblock/highsec/south/south)
"X" = (
/obj/item/stack/rods,
/turf/open/floor/plating/prison,
/area/prisonru/station/maintenance/hi/south_sec_maint)
"Y" = (
/obj/effect/decal/cleanable/dirt,
/turf/open/floor/prison/damaged2/southwest,
/area/prisonru/station/maintenance/hi/south_sec_maint)

(1,1,1) = {"
k
C
n
n
z
m
e
V
"}
(2,1,1) = {"
a
m
m
m
a
a
c
V
"}
(3,1,1) = {"
J
J
v
X
v
J
J
Q
"}
(4,1,1) = {"
J
x
P
M
Y
o
S
g
"}
(5,1,1) = {"
J
x
q
w
p
y
w
d
"}

(1,1,2) = {"
L
L
L
L
L
L
L
U
"}
(2,1,2) = {"
L
L
L
L
L
L
L
U
"}
(3,1,2) = {"
L
L
L
L
L
L
L
U
"}
(4,1,2) = {"
L
L
L
L
L
L
L
L
"}
(5,1,2) = {"
L
L
L
L
L
L
L
L
"}
