//MAP CONVERTED BY dmm2tgm.py THIS HEADER COMMENT PREVENTS RECONVERSION, DO NOT REMOVE
"a" = (
/turf/open_space,
/area/space)
"n" = (
/obj/structure/pipes/standard/simple/hidden/dark,
/obj/effect/decal/cleanable/dirt,
/obj/effect/decal/cleanable/blood,
/obj/effect/decal/heavy_cable/cable_horizontal,
/turf/open/floor/plating/prison,
/area/prisonru/station/maintenance/residential/access/south)
"p" = (
/obj/structure/window/framed/prison/reinforced/hull,
/obj/structure/blocker/invisible_wall,
/turf/open/floor/plating/prison,
/area/prisonru/station/maintenance/residential/access/south)
"r" = (
/turf/closed/wall/prison,
/area/prisonru/residential/south)
"v" = (
/turf/closed/wall/r_wall/prison_unmeltable,
/area/prisonru/residential/south)
"A" = (
/turf/closed/wall/r_wall/prison_unmeltable,
/area/prisonru/station/maintenance/residential/access/south)
"I" = (
/turf/open/floor/plating/prison,
/area/prisonru/station/maintenance/residential/access/south)
"J" = (
/obj/structure/pipes/standard/simple/hidden/dark,
/obj/effect/decal/heavy_cable/cable_horizontal,
/turf/open/floor/plating/prison,
/area/prisonru/station/maintenance/residential/access/south)
"M" = (
/obj/structure/pipes/vents/scrubber{
	dir = 8
	},
/turf/open/floor/plating/prison,
/area/prisonru/station/maintenance/residential/access/south)
"S" = (
/obj/structure/pipes/standard/manifold/hidden/dark{
	dir = 8
	},
/obj/effect/alien/weeds/node,
/obj/effect/decal/heavy_cable/cable_horizontal,
/turf/open/floor/plating/prison,
/area/prisonru/station/maintenance/residential/access/south)
"T" = (
/obj/effect/decal/cleanable/dirt,
/obj/effect/decal/cleanable/blood,
/turf/open/floor/plating/prison,
/area/prisonru/station/maintenance/residential/access/south)

(1,1,1) = {"
v
r
r
r
"}
(2,1,1) = {"
I
I
I
I
"}
(3,1,1) = {"
J
J
S
n
"}
(4,1,1) = {"
T
I
M
I
"}
(5,1,1) = {"
p
p
A
p
"}

(1,1,2) = {"
a
a
a
a
"}
(2,1,2) = {"
a
a
a
a
"}
(3,1,2) = {"
a
a
a
a
"}
(4,1,2) = {"
a
a
a
a
"}
(5,1,2) = {"
a
a
a
a
"}
