//MAP CONVERTED BY dmm2tgm.py THIS HEADER COMMENT PREVENTS RECONVERSION, DO NOT REMOVE
"aa" = (
/obj/structure/flora/pottedplant{
	icon_state = "pottedplant_2";
	pixel_x = 4;
	pixel_y = 9
	},
/turf/open/floor/prison,
/area/prisonru/station/visitation)
"ab" = (
/obj/structure/machinery/vending/snack{
	pixel_y = 16;
	density = 0;
	pixel_x = -6
	},
/turf/open/floor/prison,
/area/prisonru/station/visitation)
"ac" = (
/obj/structure/roof/hybrisa/billboardsandsigns/billboardsmedium/billboard2{
	dir = 5;
	pixel_y = 34;
	lazy_nodes = 0;
	layer = 3
	},
/turf/open/floor/prison,
/area/prisonru/station/visitation)
"ad" = (
/obj/structure/roof/hybrisa/billboardsandsigns/billboardsmedium/billboard2{
	dir = 1;
	pixel_y = 34;
	lazy_nodes = 0;
	layer = 3
	},
/turf/open/floor/prison,
/area/prisonru/station/visitation)
"ae" = (
/obj/structure/machinery/vending/cola{
	density = 0;
	pixel_y = 16;
	pixel_x = 2
	},
/turf/open/floor/prison,
/area/prisonru/station/visitation)
"af" = (
/turf/closed/wall/r_wall/prison,
/area/prisonru/station/visitation)
"ag" = (
/turf/closed/wall/prison,
/area/prisonru/station/store)
"ah" = (
/obj/effect/decal/cleanable/dirt,
/turf/closed/wall/prison,
/area/prisonru/station/store)
"ai" = (
/turf/closed/wall/r_wall/prison,
/area/prisonru/station/toilet/canteen)
"aI" = (
/turf/open/floor/prison/darkredfull2/southwest,
/area/prisonru/station/visitation)
"bR" = (
/obj/structure/pipes/vents/scrubber{
	dir = 4
	},
/obj/structure/bed/chair/office/dark{
	dir = 1
	},
/obj/item/shard/shrapnel,
/obj/effect/decal/cleanable/blood/oil,
/turf/open/floor/prison/darkredcorners2/east,
/area/prisonru/station/visitation)
"ch" = (
/obj/structure/pipes/vents/scrubber{
	dir = 8
	},
/obj/item/stack/sheet/metal,
/obj/structure/roof/hybrisa/billboardsandsigns/billboardsmedium/billboard2{
	pixel_y = 32;
	pixel_x = -16
	},
/turf/open/floor/prison,
/area/prisonru/station/visitation)
"cu" = (
/obj/structure/pipes/vents/scrubber{
	dir = 8
	},
/turf/open/floor/prison,
/area/prisonru/station/visitation)
"dW" = (
/obj/structure/pipes/standard/simple/hidden/dark{
	dir = 4
	},
/turf/open/floor/prison,
/area/prisonru/station/visitation)
"eo" = (
/obj/structure/pipes/vents/pump{
	dir = 8
	},
/turf/open/floor/prison/darkred2/east,
/area/prisonru/station/visitation)
"eF" = (
/obj/structure/pipes/standard/simple/hidden/supply,
/obj/structure/disposalpipe/segment,
/obj/structure/machinery/door/airlock/multi_tile/almayer/generic{
	name = "Visitation";
	welded = 1
	},
/turf/open/floor/prison,
/area/prisonru/station/visitation)
"eR" = (
/obj/item/stack/sheet/metal{
	pixel_x = -13;
	pixel_y = 14
	},
/obj/item/paper_bin{
	pixel_x = -3;
	pixel_y = 7
	},
/obj/structure/pipes/standard/simple/hidden/dark,
/turf/open/floor/prison/darkredcorners2/east,
/area/prisonru/station/visitation)
"fj" = (
/obj/effect/decal/cleanable/blood,
/obj/effect/decal/cleanable/dirt,
/turf/open/floor/prison,
/area/prisonru/station/visitation)
"fF" = (
/obj/structure/bed/chair/office/dark,
/obj/effect/decal/cleanable/dirt,
/turf/open/floor/prison,
/area/prisonru/station/visitation)
"ge" = (
/obj/item/stack/sheet/metal{
	pixel_x = -13;
	pixel_y = 14
	},
/obj/item/shard{
	icon_state = "medium"
	},
/obj/item/stack/cable_coil{
	amount = 1
	},
/obj/effect/decal/cleanable/blood/oil,
/obj/structure/pipes/standard/simple/hidden/dark,
/turf/open/floor/prison,
/area/prisonru/station/visitation)
"hJ" = (
/turf/closed/wall/prison{
	damage = 200
	},
/area/prisonru/station/visitation)
"ja" = (
/obj/effect/decal/cleanable/dirt,
/turf/open/floor/prison,
/area/prisonru/station/visitation)
"jJ" = (
/obj/effect/decal/cleanable/blood,
/turf/open/floor/prison/damaged2/southwest,
/area/prisonru/station/visitation)
"kP" = (
/turf/open/floor/prison/darkred2/northwest,
/area/prisonru/station/visitation)
"lb" = (
/obj/structure/machinery/light/double/blue{
	dir = 1;
	pixel_y = 21
	},
/turf/open/floor/prison,
/area/prisonru/station/visitation)
"ma" = (
/obj/item/shard{
	icon_state = "small"
	},
/turf/open/floor/prison/damaged2,
/area/prisonru/station/visitation)
"mg" = (
/obj/item/shard{
	icon_state = "medium";
	pixel_x = -10;
	pixel_y = -8
	},
/obj/structure/surface/table/reinforced/prison{
	dir = 1;
	color = "#8e98a0"
	},
/turf/open/floor/prison,
/area/prisonru/station/visitation)
"mu" = (
/obj/structure/window_frame/prison/reinforced,
/obj/item/shard{
	icon_state = "small"
	},
/turf/open/floor/plating/prison,
/area/prisonru/station/visitation)
"mY" = (
/obj/item/stack/sheet/metal{
	pixel_x = -13;
	pixel_y = 14
	},
/turf/open/floor/prison/darkredfull2/southwest,
/area/prisonru/station/visitation)
"nd" = (
/obj/structure/machinery/computer/secure_data{
	dir = 8
	},
/obj/structure/surface/table/reinforced/prison{
	dir = 1;
	color = "#8e98a0"
	},
/obj/structure/machinery/light/double/blue{
	dir = 4;
	pixel_x = 10;
	pixel_y = -1
	},
/turf/open/floor/prison/darkredfull2/southwest,
/area/prisonru/station/visitation)
"ni" = (
/obj/item/tool/weldingtool/simple,
/obj/structure/pipes/standard/manifold/hidden/dark,
/turf/open/floor/prison,
/area/prisonru/station/visitation)
"nN" = (
/turf/open/floor/prison,
/area/prisonru/station/visitation)
"nZ" = (
/obj/structure/filingcabinet,
/obj/effect/landmark/objective_landmark/close,
/turf/open/floor/prison/darkredfull2/southwest,
/area/prisonru/station/visitation)
"ol" = (
/obj/structure/machinery/door/airlock/almayer/security/glass/colony{
	name = "Security Booth"
	},
/turf/open/floor/prison,
/area/prisonru/station/visitation)
"pN" = (
/obj/structure/machinery/light/double/blue{
	pixel_y = -1
	},
/turf/open/floor/prison,
/area/prisonru/station/visitation)
"qi" = (
/turf/open_space,
/area/space)
"qt" = (
/turf/open/floor/prison/darkred2/northeast,
/area/prisonru/station/visitation)
"qy" = (
/turf/open/floor/prison/darkred2/southwest,
/area/prisonru/station/visitation)
"rh" = (
/obj/structure/bed/chair/office/dark{
	dir = 4
	},
/turf/open/floor/prison/darkred2/east,
/area/prisonru/station/visitation)
"rZ" = (
/turf/closed/wall/r_wall/prison,
/area/prisonru/station/store)
"sQ" = (
/turf/closed/wall/prison,
/area/space)
"sW" = (
/obj/item/shard{
	icon_state = "medium"
	},
/obj/structure/pipes/standard/simple/hidden/dark,
/turf/open/floor/prison/darkred2/northwest,
/area/prisonru/station/visitation)
"ua" = (
/obj/item/stack/sheet/metal,
/turf/open/floor/prison/darkred2/southeast,
/area/prisonru/station/visitation)
"uC" = (
/obj/structure/pipes/standard/simple/hidden/dark{
	dir = 4
	},
/obj/structure/machinery/door/airlock/multi_tile/almayer/generic{
	dir = 2;
	name = "Visitation";
	welded = 1
	},
/turf/open/floor/prison,
/area/prisonru/station/visitation)
"uY" = (
/obj/structure/pipes/standard/manifold/hidden/supply{
	dir = 1
	},
/obj/effect/decal/cleanable/dirt,
/turf/open/floor/prison,
/area/prisonru/station/visitation)
"vp" = (
/obj/structure/pipes/standard/manifold/hidden/dark{
	dir = 1
	},
/turf/open/floor/prison,
/area/prisonru/station/visitation)
"vw" = (
/turf/closed/wall/r_wall/prison,
/area/space)
"we" = (
/obj/structure/machinery/computer/cameras{
	network = list("PRISON");
	dir = 4
	},
/obj/structure/surface/table/reinforced/prison{
	dir = 1;
	color = "#8e98a0"
	},
/turf/open/floor/prison/damaged2,
/area/prisonru/station/visitation)
"xn" = (
/turf/open/floor/prison/darkred2,
/area/prisonru/station/visitation)
"yq" = (
/obj/item/shard{
	icon_state = "small"
	},
/turf/open/floor/prison,
/area/prisonru/station/visitation)
"yZ" = (
/obj/structure/machinery/door/airlock/multi_tile/almayer/generic{
	name = "Visitation";
	welded = 1
	},
/turf/open/floor/prison,
/area/prisonru/station/visitation)
"zJ" = (
/obj/structure/bed/chair{
	dir = 4
	},
/turf/open/floor/prison,
/area/prisonru/station/visitation)
"AG" = (
/turf/closed/wall/prison,
/area/prisonru/station/visitation)
"BM" = (
/obj/structure/window_frame/prison/reinforced,
/turf/open/floor/plating/prison,
/area/prisonru/station/visitation)
"CA" = (
/obj/item/stack/sheet/metal,
/turf/open/floor/prison,
/area/prisonru/station/visitation)
"CM" = (
/obj/effect/decal/cleanable/dirt,
/turf/closed/wall/prison,
/area/prisonru/station/visitation)
"Ds" = (
/obj/structure/pipes/standard/simple/hidden/dark{
	dir = 4
	},
/obj/item/tool/pen{
	pixel_x = 9;
	pixel_y = 8
	},
/turf/open/floor/prison/damaged2/southwest,
/area/prisonru/station/visitation)
"Hu" = (
/obj/structure/bed/chair{
	dir = 1
	},
/turf/open/floor/prison,
/area/prisonru/station/visitation)
"HI" = (
/turf/open/floor/prison/damaged2/southwest,
/area/prisonru/station/visitation)
"JK" = (
/turf/closed/wall/prison{
	damage = 600
	},
/area/prisonru/station/visitation)
"JQ" = (
/turf/open/floor/prison/damaged2,
/area/prisonru/station/visitation)
"KJ" = (
/obj/structure/pipes/standard/simple/hidden/dark,
/turf/open/floor/prison,
/area/prisonru/station/visitation)
"Mx" = (
/obj/structure/window/framed/prison/reinforced,
/turf/open/floor/plating/prison,
/area/prisonru/station/visitation)
"MD" = (
/obj/item/stack/cable_coil{
	amount = 1
	},
/turf/open/floor/prison/damaged2/southwest,
/area/prisonru/station/visitation)
"NL" = (
/obj/structure/surface/table/reinforced/prison{
	dir = 1;
	color = "#8e98a0"
	},
/turf/open/floor/prison,
/area/prisonru/station/visitation)
"NT" = (
/obj/item/device/flashlight/lamp,
/obj/effect/landmark/item_pool_spawner/prison_lock,
/obj/structure/surface/table/reinforced/prison{
	dir = 1;
	color = "#8e98a0"
	},
/turf/open/floor/prison/darkredfull2/southwest,
/area/prisonru/station/visitation)
"OV" = (
/obj/effect/landmark/corpsespawner/ua_riot,
/turf/open/floor/prison/darkred2/northwest,
/area/prisonru/station/visitation)
"Ri" = (
/obj/effect/decal/cleanable/dirt,
/obj/effect/decal/cleanable/dirt,
/obj/effect/landmark/corpsespawner/prisoner,
/turf/open/floor/prison,
/area/prisonru/station/visitation)
"RW" = (
/obj/structure/pipes/vents/pump{
	dir = 4
	},
/obj/item/shard/shrapnel,
/turf/open/floor/prison/damaged2/southwest,
/area/prisonru/station/visitation)
"So" = (
/obj/structure/pipes/vents/pump{
	dir = 4
	},
/turf/open/floor/prison,
/area/prisonru/station/visitation)
"Tb" = (
/obj/effect/decal/cleanable/blood,
/turf/open/floor/prison,
/area/prisonru/station/visitation)
"Tz" = (
/obj/structure/machinery/power/apc{
	dir = 1;
	pixel_y = 24;
	start_charge = 0
	},
/turf/open/floor/prison,
/area/prisonru/station/visitation)
"Vz" = (
/obj/structure/bed/chair/office/dark,
/turf/open/floor/prison,
/area/prisonru/station/visitation)
"XF" = (
/turf/open/floor/prison/damaged1,
/area/prisonru/station/visitation)
"Zh" = (
/obj/structure/flora/pottedplant,
/obj/structure/machinery/light/double/blue{
	dir = 4;
	pixel_x = 10;
	pixel_y = -1
	},
/turf/open/floor/prison,
/area/prisonru/station/visitation)
"Zt" = (
/obj/structure/machinery/computer/cameras{
	network = list("PRISON");
	dir = 8
	},
/obj/structure/surface/table/reinforced/prison{
	dir = 1;
	color = "#8e98a0"
	},
/turf/open/floor/prison/darkredfull2/southwest,
/area/prisonru/station/visitation)
"ZE" = (
/obj/structure/pipes/standard/manifold/hidden/dark,
/turf/open/floor/prison,
/area/prisonru/station/visitation)

(1,1,1) = {"
rZ
ah
ag
ag
ag
ag
ag
ag
ag
rZ
"}
(2,1,1) = {"
AG
ab
ja
fF
NL
Mx
Hu
nN
zJ
AG
"}
(3,1,1) = {"
Mx
nN
nN
nN
AG
CM
AG
nN
So
Mx
"}
(4,1,1) = {"
yZ
nN
nN
Vz
NL
Mx
Hu
nN
uY
eF
"}
(5,1,1) = {"
nN
nN
nN
nN
AG
AG
AG
nN
dW
nN
"}
(6,1,1) = {"
Mx
nN
Tb
fF
mg
BM
Hu
nN
cu
Mx
"}
(7,1,1) = {"
AG
nN
nN
nN
AG
AG
AG
Tb
nN
AG
"}
(8,1,1) = {"
ai
lb
nN
fF
NL
mu
Hu
nN
pN
AG
"}
(9,1,1) = {"
ai
ac
XF
nN
hJ
AG
hJ
nN
nN
AG
"}
(10,1,1) = {"
ai
nN
nN
fj
JK
JK
JK
yq
nN
AG
"}
(11,1,1) = {"
ai
nN
XF
Ri
HI
JQ
nN
jJ
nN
AG
"}
(12,1,1) = {"
ai
ad
CA
Tb
HI
ma
JQ
nN
aa
AG
"}
(13,1,1) = {"
ai
nN
yq
RW
JQ
nN
HI
ol
Mx
af
"}
(14,1,1) = {"
ai
nN
nN
dW
MD
mY
we
kP
qy
af
"}
(15,1,1) = {"
ai
Tz
HI
Ds
HI
aI
OV
bR
xn
af
"}
(16,1,1) = {"
ai
ae
nN
vp
ge
sW
eR
ZE
xn
af
"}
(17,1,1) = {"
ai
ch
KJ
ni
mu
qt
rh
eo
ua
af
"}
(18,1,1) = {"
ai
Zh
nN
dW
af
Zt
nd
NT
nZ
af
"}
(19,1,1) = {"
ai
af
nN
uC
af
af
af
af
af
af
"}

(1,1,2) = {"
vw
sQ
sQ
sQ
sQ
sQ
sQ
sQ
sQ
vw
"}
(2,1,2) = {"
sQ
qi
qi
qi
qi
qi
qi
qi
qi
sQ
"}
(3,1,2) = {"
qi
qi
qi
qi
sQ
sQ
sQ
qi
qi
qi
"}
(4,1,2) = {"
qi
qi
qi
qi
qi
qi
qi
qi
qi
qi
"}
(5,1,2) = {"
qi
qi
qi
qi
sQ
sQ
sQ
qi
qi
qi
"}
(6,1,2) = {"
qi
qi
qi
qi
qi
qi
qi
qi
qi
qi
"}
(7,1,2) = {"
sQ
qi
qi
qi
sQ
sQ
sQ
qi
qi
sQ
"}
(8,1,2) = {"
vw
qi
qi
qi
qi
qi
qi
qi
qi
sQ
"}
(9,1,2) = {"
vw
qi
qi
qi
sQ
sQ
sQ
qi
qi
sQ
"}
(10,1,2) = {"
vw
qi
qi
qi
sQ
sQ
sQ
qi
qi
sQ
"}
(11,1,2) = {"
vw
qi
qi
qi
qi
qi
qi
qi
qi
sQ
"}
(12,1,2) = {"
vw
qi
qi
qi
qi
qi
qi
qi
qi
sQ
"}
(13,1,2) = {"
vw
qi
qi
qi
qi
qi
qi
qi
qi
vw
"}
(14,1,2) = {"
vw
qi
qi
qi
qi
qi
qi
qi
qi
vw
"}
(15,1,2) = {"
vw
qi
qi
qi
qi
qi
qi
qi
qi
vw
"}
(16,1,2) = {"
vw
qi
qi
qi
qi
qi
qi
qi
qi
vw
"}
(17,1,2) = {"
vw
qi
qi
qi
qi
qi
qi
qi
qi
vw
"}
(18,1,2) = {"
vw
qi
qi
qi
vw
qi
qi
qi
qi
vw
"}
(19,1,2) = {"
vw
vw
qi
qi
vw
vw
vw
vw
vw
vw
"}
