//MAP CONVERTED BY dmm2tgm.py THIS HEADER COMMENT PREVENTS RECONVERSION, DO NOT REMOVE
"aa" = (
/obj/structure/pipes/standard/simple/hidden/dark{
	dir = 4
	},
/turf/open/floor/almayer/black/east,
/area/prisonru/research)
"ab" = (
/obj/structure/pipes/standard/simple/hidden/dark{
	dir = 9
	},
/turf/open/floor/hybrisa/tile/tileblackcheckered,
/area/prisonru/research)
"ac" = (
/turf/open_space,
/area/prisonru/oob)
"ad" = (
/obj/structure/flora/pottedplant{
	icon_state = "pottedplant_21"
	},
/turf/open/floor/almayer/blackfull/west,
/area/prisonru/research)
"ag" = (
/obj/structure/machinery/alarm{
	pixel_y = 24
	},
/obj/effect/decal/cleanable/dirt,
/obj/structure/reagent_dispensers/water_cooler{
	density = 0;
	pixel_x = -10;
	pixel_y = 19
	},
/turf/open/floor/almayer/black/north,
/area/prisonru/research)
"as" = (
/obj/structure/pipes/standard/simple/hidden/dark{
	dir = 4
	},
/obj/structure/disposalpipe/segment{
	dir = 4
	},
/turf/open/floor/almayer/blackfull/west,
/area/prisonru/research)
"ax" = (
/obj/effect/landmark/objective_landmark/close,
/obj/effect/decal/cleanable/dirt,
/obj/structure/surface/table/reinforced/prison{
	dir = 1;
	color = "#8e98a0"
	},
/obj/item/reagent_container/food/snacks/mre_pack/meal4,
/turf/open/floor/almayer/blackfull/west,
/area/prisonru/research)
"aG" = (
/obj/structure/pipes/standard/simple/hidden/dark{
	dir = 4
	},
/obj/structure/disposalpipe/segment{
	dir = 4
	},
/turf/open/floor/corsat/squares,
/area/prisonru/research)
"bc" = (
/obj/structure/pipes/standard/simple/hidden/dark{
	dir = 4
	},
/turf/open/floor/prison/whitepurple,
/area/prisonru/station/quarters/research)
"bn" = (
/obj/structure/surface/table/reinforced/prison{
	dir = 1;
	color = "#8e98a0"
	},
/obj/structure/machinery/hybrisa/coffee_machine{
	pixel_x = -5
	},
/obj/item/tool/kitchen/utensil/pfork{
	pixel_x = 8;
	pixel_y = 8
	},
/turf/open/floor/hybrisa/tile/tileblackcheckered,
/area/prisonru/research)
"bK" = (
/obj/structure/inflatable/popped,
/obj/effect/decal/cleanable/blood/drip,
/turf/open/floor/prison/whitepurple/north,
/area/prisonru/station/quarters/research)
"bW" = (
/obj/structure/pipes/standard/simple/hidden/dark,
/obj/structure/disposalpipe/segment,
/obj/structure/machinery/door/airlock/multi_tile/almayer/generic{
	name = "Research Common Room";
	welded = 0
	},
/turf/open/floor/almayer/blackfull/west,
/area/prisonru/research)
"co" = (
/obj/structure/surface/table/reinforced/prison{
	dir = 1;
	color = "#8e98a0"
	},
/obj/item/reagent_container/food/drinks/sillycup{
	pixel_x = -7;
	pixel_y = 10
	},
/turf/open/floor/corsat/squares,
/area/prisonru/research)
"cp" = (
/obj/structure/pipes/standard/manifold/hidden/dark{
	dir = 1
	},
/obj/effect/landmark/objective_landmark/close,
/turf/open/floor/hybrisa/tile/tilewhitecheckered/blue,
/area/prisonru/station/toilet/research)
"cW" = (
/obj/structure/pipes/standard/simple/hidden/dark{
	dir = 5
	},
/obj/structure/disposalpipe/segment{
	dir = 1;
	icon_state = "pipe-c"
	},
/obj/structure/surface/table/reinforced/prison{
	dir = 1;
	color = "#8e98a0"
	},
/obj/item/reagent_container/food/snacks/mre_pack/meal3,
/obj/item/reagent_container/food/snacks/mre_pack/meal1{
	desc = "A tray of standard W-Y 'flight' food. This one is what resembles Corn-bread. Disgusting.";
	name = "\improper W-Y Prepared Meal (cornbread)";
	pixel_x = -1;
	pixel_y = 6
	},
/turf/open/floor/almayer/black/south,
/area/prisonru/research)
"do" = (
/turf/open/floor/almayer/blackfull/west,
/area/prisonru/research)
"dT" = (
/obj/structure/pipes/standard/simple/hidden/dark{
	dir = 6
	},
/turf/open/floor/corsat/squares,
/area/prisonru/research)
"ev" = (
/obj/structure/pipes/vents/pump{
	dir = 4
	},
/obj/structure/machinery/vending/coffee{
	density = 0;
	pixel_x = -15
	},
/turf/open/floor/almayer/black/west,
/area/prisonru/research)
"eD" = (
/obj/structure/machinery/vending/cola{
	pixel_x = 8;
	density = 0
	},
/turf/open/floor/corsat/squares,
/area/prisonru/research)
"eS" = (
/turf/closed/wall/r_wall/prison_unmeltable,
/area/prisonru/oob)
"eY" = (
/obj/structure/pipes/standard/simple/hidden/dark{
	dir = 4
	},
/turf/open/floor/almayer/black/southeast,
/area/prisonru/research)
"fN" = (
/obj/structure/pipes/standard/simple/hidden/dark{
	dir = 4
	},
/obj/effect/decal/cleanable/blood/drip,
/turf/open/floor/almayer/blackfull/west,
/area/prisonru/research)
"fO" = (
/obj/structure/reagent_dispensers/water_cooler{
	pixel_x = 11;
	pixel_y = 8;
	density = 0
	},
/turf/open/floor/almayer/black/east,
/area/prisonru/research)
"fX" = (
/obj/item/trash/cigbutt,
/turf/open/floor/hybrisa/tile/tilewhitecheckered/blue,
/area/prisonru/station/toilet/research)
"gi" = (
/obj/structure/sign/safety/coffee{
	pixel_y = -7;
	pixel_x = 33
	},
/obj/structure/machinery/vending/cigarette/wy{
	density = 0;
	pixel_x = -5;
	pixel_y = 16
	},
/turf/open/floor/almayer/black/northeast,
/area/prisonru/research)
"gl" = (
/obj/structure/pipes/standard/simple/hidden/dark{
	dir = 5
	},
/obj/structure/machinery/power/apc/no_power/south,
/turf/open/floor/hybrisa/tile/tilewhitecheckered/blue,
/area/prisonru/station/toilet/research)
"gM" = (
/turf/open/floor/prison/whitepurple/north,
/area/prisonru/station/quarters/research)
"ho" = (
/obj/effect/landmark/item_pool_spawner/survivor_ammo/buckshot,
/obj/structure/surface/table/reinforced/prison{
	dir = 1;
	color = "#8e98a0"
	},
/obj/item/tool/kitchen/utensil/pfork{
	pixel_x = -16;
	pixel_y = 1
	},
/turf/open/floor/corsat/squares,
/area/prisonru/research)
"hv" = (
/obj/structure/machinery/vending/dinnerware{
	pixel_x = -6
	},
/obj/structure/closet/secure_closet/freezer/fridge/full{
	pixel_x = 12
	},
/turf/open/floor/hybrisa/tile/tileblackcheckered,
/area/prisonru/research)
"iI" = (
/obj/structure/bed/chair/office/light{
	dir = 1
	},
/turf/open/floor/corsat/squares,
/area/prisonru/research)
"iM" = (
/obj/structure/pipes/vents/pump{
	dir = 8
	},
/obj/effect/decal/cleanable/dirt,
/turf/open/floor/hybrisa/tile/tileblackcheckered,
/area/prisonru/research)
"jx" = (
/obj/structure/pipes/standard/simple/hidden/dark,
/turf/open/floor/almayer/black/west,
/area/prisonru/research)
"kU" = (
/obj/structure/pipes/vents/scrubber{
	dir = 8
	},
/turf/open/floor/hybrisa/tile/tileblackcheckered,
/area/prisonru/research)
"kX" = (
/obj/item/pizzabox,
/obj/effect/landmark/item_pool_spawner/survivor_ammo/buckshot,
/obj/structure/surface/table/reinforced/prison{
	dir = 1;
	color = "#8e98a0"
	},
/turf/open/floor/corsat/squares,
/area/prisonru/research)
"kZ" = (
/turf/open/floor/almayer/black/east,
/area/prisonru/research)
"lu" = (
/obj/structure/pipes/standard/simple/hidden/dark{
	dir = 4
	},
/turf/open/floor/almayer/black/west,
/area/prisonru/research)
"lJ" = (
/obj/structure/pipes/standard/manifold/hidden/dark,
/obj/effect/decal/cleanable/blood/drip,
/turf/open/floor/almayer/black,
/area/prisonru/research)
"lM" = (
/obj/structure/pipes/vents/scrubber{
	dir = 1
	},
/turf/open/floor/almayer/black/southwest,
/area/prisonru/research)
"mS" = (
/obj/structure/pipes/standard/manifold/hidden/dark{
	dir = 4
	},
/obj/structure/disposalpipe/segment,
/turf/open/floor/almayer/blackfull/west,
/area/prisonru/research)
"ns" = (
/obj/structure/closet/emcloset,
/turf/open/floor/almayer/black/southeast,
/area/prisonru/research)
"nA" = (
/obj/structure/bed/chair/office/light{
	dir = 1
	},
/obj/effect/decal/cleanable/dirt,
/turf/open/floor/corsat/squares,
/area/prisonru/research)
"nL" = (
/obj/effect/decal/cleanable/dirt,
/obj/structure/surface/table/reinforced/prison{
	dir = 1;
	color = "#8e98a0"
	},
/obj/item/storage/box/donkpockets{
	pixel_x = -5;
	pixel_y = 7
	},
/obj/item/storage/box/donkpockets{
	pixel_x = 8;
	pixel_y = 7
	},
/obj/item/storage/box/donkpockets{
	pixel_x = 8;
	pixel_y = 2
	},
/turf/open/floor/hybrisa/tile/tileblackcheckered,
/area/prisonru/research)
"oi" = (
/obj/structure/machinery/door/airlock/multi_tile/almayer/comdoor/colony{
	dir = 2;
	name = "Biological Research Department";
	welded = 1
	},
/turf/open/floor/almayer/blackfull/west,
/area/prisonru/research)
"oX" = (
/turf/closed/wall/r_wall/prison,
/area/prisonru/station/toilet/research)
"pK" = (
/obj/structure/machinery/gibber,
/turf/open/floor/hybrisa/tile/tileblackcheckered,
/area/prisonru/research)
"pS" = (
/obj/structure/window/framed/prison/reinforced,
/obj/structure/machinery/door/poddoor/hybrisa/open_shutters{
	dir = 4
	},
/turf/open/floor/plating/prison,
/area/prisonru/research)
"pV" = (
/obj/structure/surface/table/reinforced/prison{
	dir = 1;
	color = "#8e98a0"
	},
/obj/item/reagent_container/food/drinks/sillycup{
	pixel_x = -5;
	pixel_y = 10
	},
/obj/item/reagent_container/food/drinks/cans/classcola{
	icon_state = "cola_crushed"
	},
/turf/open/floor/almayer/blackfull/west,
/area/prisonru/research)
"qv" = (
/turf/closed/wall/r_wall/prison_unmeltable,
/area/prisonru/research)
"qF" = (
/obj/structure/machinery/vending/snack{
	pixel_x = 8;
	density = 0
	},
/obj/effect/decal/cleanable/generic,
/turf/open/floor/almayer/blackfull/west,
/area/prisonru/research)
"qM" = (
/obj/structure/sink{
	pixel_y = 15
	},
/turf/open/floor/almayer/black/northeast,
/area/prisonru/research)
"qO" = (
/obj/effect/decal/cleanable/dirt,
/turf/open/floor/almayer/black/east,
/area/prisonru/research)
"re" = (
/obj/structure/disposalpipe/segment,
/obj/structure/pipes/standard/manifold/hidden/dark{
	dir = 4
	},
/turf/open/floor/corsat/squares,
/area/prisonru/research)
"rf" = (
/obj/effect/decal/cleanable/dirt,
/obj/structure/surface/table/reinforced/prison{
	dir = 1;
	color = "#8e98a0"
	},
/obj/item/tool/kitchen/utensil/pknife{
	pixel_x = 8;
	pixel_y = -1
	},
/obj/item/tool/kitchen/utensil/pspoon{
	pixel_y = 1
	},
/obj/item/reagent_container/food/drinks/sillycup{
	pixel_x = -5;
	pixel_y = 10
	},
/obj/item/reagent_container/food/condiment/saltshaker,
/obj/item/reagent_container/food/condiment/peppermill{
	pixel_x = 3;
	pixel_y = 9
	},
/turf/open/floor/almayer/blackfull/west,
/area/prisonru/research)
"sk" = (
/obj/item/clothing/head/chefhat,
/obj/item/tool/kitchen/rollingpin,
/obj/structure/surface/table/reinforced/prison{
	dir = 1;
	color = "#8e98a0"
	},
/obj/item/tool/kitchen/knife/butcher,
/turf/open/floor/hybrisa/tile/tileblackcheckered,
/area/prisonru/research)
"tg" = (
/obj/structure/pipes/standard/simple/hidden/dark{
	dir = 10
	},
/obj/effect/decal/cleanable/dirt,
/turf/open/floor/almayer/black/east,
/area/prisonru/research)
"tm" = (
/obj/effect/decal/cleanable/dirt,
/obj/structure/machinery/door/airlock/almayer/generic/autoname{
	dir = 8
	},
/obj/structure/pipes/standard/simple/hidden/dark{
	dir = 4
	},
/turf/open/floor/hybrisa/tile/tileblackcheckered,
/area/prisonru/research)
"tY" = (
/turf/closed/wall/r_wall/prison,
/area/prisonru/lz/near_lzII)
"um" = (
/obj/structure/pipes/standard/simple/hidden/dark{
	dir = 4
	},
/obj/structure/disposalpipe/segment{
	dir = 4
	},
/obj/structure/machinery/light/double/blue,
/obj/structure/surface/table/reinforced/prison{
	dir = 1;
	color = "#8e98a0"
	},
/obj/item/trash/tray{
	pixel_x = -1;
	pixel_y = 9
	},
/obj/item/trash/tray{
	pixel_y = 1
	},
/obj/item/trash/tray{
	pixel_y = 7
	},
/turf/open/floor/almayer/black/south,
/area/prisonru/research)
"uv" = (
/obj/structure/machinery/photocopier,
/turf/open/floor/almayer/black/west,
/area/prisonru/research)
"vL" = (
/obj/structure/pipes/standard/simple/hidden/dark{
	dir = 4
	},
/obj/structure/inflatable{
	opacity = 1
	},
/turf/open/floor/prison/whitepurple/southwest,
/area/prisonru/station/quarters/research)
"wh" = (
/obj/structure/pipes/standard/simple/hidden/dark,
/obj/structure/disposalpipe/segment,
/turf/open/floor/corsat/squares,
/area/prisonru/research)
"xa" = (
/obj/item/stool{
	pixel_x = 4;
	pixel_y = 9
	},
/turf/open/floor/hybrisa/tile/tileblackcheckered,
/area/prisonru/research)
"xn" = (
/obj/effect/decal/cleanable/dirt,
/obj/effect/decal/cleanable/dirt,
/obj/structure/surface/table/reinforced/prison{
	dir = 1;
	color = "#8e98a0"
	},
/obj/item/tool/kitchen/utensil/pfork{
	pixel_x = -7;
	pixel_y = 1
	},
/obj/item/tool/kitchen/utensil/pfork,
/obj/item/trash/tray,
/obj/item/trash/tray{
	pixel_y = 3
	},
/turf/open/floor/hybrisa/tile/tileblackcheckered,
/area/prisonru/research)
"xE" = (
/obj/effect/decal/cleanable/dirt,
/obj/structure/bed/chair/office/light,
/turf/open/floor/corsat/squares,
/area/prisonru/research)
"xH" = (
/turf/open/floor/corsat/squares,
/area/prisonru/research)
"xI" = (
/obj/structure/surface/table/reinforced/prison{
	dir = 1;
	color = "#8e98a0"
	},
/obj/structure/machinery/light/double/blue{
	dir = 1;
	pixel_y = 21
	},
/obj/structure/machinery/processor{
	pixel_x = -1;
	pixel_y = 3
	},
/turf/open/floor/hybrisa/tile/tileblackcheckered,
/area/prisonru/research)
"yz" = (
/obj/effect/decal/siding{
	icon_state = "siding2"
	},
/obj/structure/barricade/handrail/wire{
	layer = 3.1
	},
/turf/open/floor/almayer/blackfull/west,
/area/prisonru/research)
"yM" = (
/obj/effect/decal/cleanable/blood,
/obj/effect/decal/cleanable/dirt,
/turf/open/floor/almayer/blackfull/west,
/area/prisonru/research)
"yV" = (
/obj/structure/pipes/standard/manifold/hidden/dark{
	dir = 1
	},
/obj/structure/disposalpipe/segment{
	dir = 2;
	icon_state = "pipe-c"
	},
/turf/open/floor/almayer/blackcorner/west,
/area/prisonru/research)
"Ab" = (
/obj/structure/pipes/standard/manifold/hidden/dark{
	dir = 8
	},
/turf/open/floor/hybrisa/tile/tileblackcheckered,
/area/prisonru/research)
"AJ" = (
/obj/structure/bed/chair/office/light,
/obj/item/ammo_casing/bullet,
/obj/item/trash/cigbutt,
/turf/open/floor/corsat/squares,
/area/prisonru/research)
"AU" = (
/obj/structure/sink{
	dir = 8;
	pixel_x = -11
	},
/obj/structure/mirror{
	pixel_x = -26
	},
/obj/structure/pipes/standard/simple/hidden/dark,
/turf/open/floor/hybrisa/tile/tilewhitecheckered/blue,
/area/prisonru/station/toilet/research)
"Bv" = (
/obj/structure/surface/table/reinforced/prison{
	dir = 1;
	color = "#8e98a0"
	},
/obj/item/tool/kitchen/knife,
/obj/structure/machinery/hybrisa/coffee_machine{
	pixel_x = 7
	},
/obj/item/reagent_container/food/snacks/donkpocket{
	pixel_x = -2;
	pixel_y = -17
	},
/turf/open/floor/hybrisa/tile/tileblackcheckered,
/area/prisonru/research)
"Cg" = (
/obj/structure/machinery/light/double/blue{
	dir = 4;
	pixel_x = 10;
	pixel_y = -1
	},
/obj/item/trash/cigbutt,
/turf/open/floor/almayer/black/northeast,
/area/prisonru/research)
"Cl" = (
/turf/closed/wall/r_wall/prison,
/area/prisonru/research)
"CY" = (
/obj/structure/sink{
	pixel_y = 15
	},
/turf/open/floor/almayer/black/northwest,
/area/prisonru/research)
"CZ" = (
/obj/structure/machinery/door/airlock/multi_tile/almayer/comdoor/colony{
	dir = 2;
	name = "Research Common Room"
	},
/turf/open/floor/almayer/blackfull/west,
/area/prisonru/research)
"Dq" = (
/obj/structure/pipes/vents/scrubber{
	dir = 4
	},
/obj/structure/machinery/vending/snack{
	density = 0;
	pixel_x = -15
	},
/turf/open/floor/almayer/black/west,
/area/prisonru/research)
"Dy" = (
/turf/closed/wall/prison,
/area/prisonru/station/toilet/research)
"DS" = (
/obj/structure/pipes/standard/simple/hidden/dark{
	dir = 9
	},
/turf/open/floor/almayer/blackcorner/south,
/area/prisonru/research)
"EL" = (
/obj/structure/bed/chair/office/light,
/turf/open/floor/almayer/blackfull/west,
/area/prisonru/research)
"EQ" = (
/obj/structure/machinery/door/airlock/almayer/medical/glass/colony{
	name = "Research Dorms"
	},
/turf/open/floor/corsat/squares,
/area/prisonru/station/quarters/research)
"Fl" = (
/obj/structure/closet/firecloset,
/turf/open/floor/almayer/black,
/area/prisonru/research)
"Fw" = (
/obj/structure/window/framed/prison/reinforced,
/obj/structure/machinery/door/poddoor/hybrisa/open_shutters,
/turf/open/floor/plating/prison,
/area/prisonru/research)
"FH" = (
/turf/closed/wall/r_wall/prison,
/area/prisonru/medbay/morgue)
"Gf" = (
/obj/structure/machinery/door/airlock/almayer/generic{
	density = 0;
	icon_state = "door_open";
	name = "Toilet";
	opacity = 0
	},
/turf/open/floor/hybrisa/tile/tilewhitecheckered/blue,
/area/prisonru/station/toilet/research)
"Gz" = (
/obj/structure/filingcabinet{
	density = 0;
	pixel_y = 3;
	pixel_x = -15
	},
/obj/effect/decal/cleanable/dirt,
/turf/open/floor/almayer/black/west,
/area/prisonru/research)
"GF" = (
/obj/structure/surface/table/reinforced/prison{
	dir = 1;
	color = "#8e98a0"
	},
/obj/item/reagent_container/food/condiment/enzyme{
	pixel_y = 18;
	pixel_x = 9
	},
/obj/structure/machinery/microwave{
	pixel_x = 1;
	pixel_y = 3
	},
/turf/open/floor/hybrisa/tile/tileblackcheckered,
/area/prisonru/research)
"GZ" = (
/obj/structure/pipes/standard/simple/hidden/dark{
	dir = 6
	},
/turf/open/floor/hybrisa/tile/tileblackcheckered,
/area/prisonru/research)
"Hn" = (
/obj/structure/pipes/vents/pump/on,
/turf/open/floor/hybrisa/tile/tilewhitecheckered/blue,
/area/prisonru/station/toilet/research)
"Hq" = (
/obj/structure/bed/chair/office/light{
	dir = 8
	},
/turf/open/floor/corsat/squares,
/area/prisonru/research)
"HH" = (
/obj/structure/pipes/standard/simple/hidden/dark,
/turf/open/floor/prison/whitepurple/north,
/area/prisonru/station/quarters/research)
"Iq" = (
/obj/structure/pipes/standard/manifold/fourway/hidden/cyan{
	color = "#a6aeab"
	},
/turf/open/floor/prison/whitepurple,
/area/prisonru/station/quarters/research)
"IN" = (
/obj/effect/decal/cleanable/generic,
/turf/open/floor/almayer/black/north,
/area/prisonru/research)
"IO" = (
/obj/structure/sign/safety/restrictedarea,
/turf/closed/wall/prison,
/area/prisonru/research)
"IS" = (
/obj/effect/decal/cleanable/dirt,
/turf/open/floor/corsat/squares,
/area/prisonru/research)
"JN" = (
/obj/structure/disposalpipe/segment{
	dir = 4
	},
/obj/structure/pipes/standard/manifold/fourway/hidden/cyan{
	color = "#a6aeab"
	},
/turf/open/floor/corsat/squares,
/area/prisonru/research)
"JT" = (
/obj/structure/kitchenspike,
/turf/open/floor/hybrisa/tile/tileblackcheckered,
/area/prisonru/research)
"Ka" = (
/obj/structure/bed/chair/office/light{
	dir = 1
	},
/turf/open/floor/almayer/blackfull/west,
/area/prisonru/research)
"KE" = (
/obj/structure/pipes/vents/scrubber,
/obj/structure/machinery/light/double/blue{
	dir = 1;
	pixel_y = 21
	},
/turf/open/floor/almayer/black/north,
/area/prisonru/research)
"La" = (
/obj/structure/toilet{
	dir = 4
	},
/obj/structure/machinery/light/small/blue{
	dir = 1
	},
/turf/open/floor/hybrisa/tile/tilewhitecheckered/blue,
/area/prisonru/station/toilet/research)
"Lg" = (
/obj/effect/decal/cleanable/dirt,
/turf/open/floor/almayer/blackfull/west,
/area/prisonru/research)
"Lm" = (
/obj/structure/window/framed/prison/reinforced,
/turf/open/floor/plating/prison,
/area/prisonru/research)
"Lp" = (
/obj/structure/surface/table/reinforced/prison{
	dir = 1;
	color = "#8e98a0"
	},
/obj/item/trash/tray{
	pixel_x = -2;
	pixel_y = 5
	},
/obj/item/trash/tray,
/turf/open/floor/almayer/blackfull/west,
/area/prisonru/research)
"Ly" = (
/obj/structure/pipes/standard/simple/hidden/dark{
	dir = 4
	},
/obj/structure/machinery/door/airlock/almayer/secure/colony{
	name = "Security Booth"
	},
/turf/open/floor/corsat/squares,
/area/prisonru/research)
"LW" = (
/obj/structure/pipes/standard/simple/hidden/dark{
	dir = 4
	},
/obj/structure/disposalpipe/segment{
	dir = 4
	},
/obj/structure/surface/table/reinforced/prison{
	dir = 1;
	color = "#8e98a0"
	},
/obj/item/trash/tray,
/obj/item/trash/tray{
	pixel_x = -2;
	pixel_y = 5
	},
/obj/item/trash/tray{
	pixel_x = 2;
	pixel_y = 10
	},
/turf/open/floor/almayer/black/south,
/area/prisonru/research)
"LX" = (
/turf/open/floor/hybrisa/tile/tileblackcheckered,
/area/prisonru/research)
"LY" = (
/obj/structure/pipes/standard/simple/hidden/dark,
/obj/structure/disposalpipe/segment,
/turf/open/floor/almayer/black/north,
/area/prisonru/research)
"MA" = (
/turf/open/floor/almayer/black/north,
/area/prisonru/research)
"No" = (
/obj/structure/prop/hybrisa/misc/machinery/screens/redalert{
	light_color = "#FF0000";
	light_on = 1;
	light_power = 3;
	light_range = 5;
	pixel_x = 32
	},
/turf/open/floor/almayer/black/southeast,
/area/prisonru/research)
"Ns" = (
/obj/structure/pipes/standard/simple/hidden/dark,
/obj/structure/machinery/door/airlock/almayer/generic/autoname{
	dir = 1
	},
/turf/open/floor/hybrisa/tile/tilewhitecheckered/blue,
/area/prisonru/station/toilet/research)
"NC" = (
/obj/structure/inflatable/door,
/turf/open/floor/prison/whitepurple/northwest,
/area/prisonru/station/quarters/research)
"Op" = (
/obj/structure/surface/table/reinforced/prison{
	dir = 1;
	color = "#8e98a0"
	},
/obj/item/reagent_container/food/drinks/cans/sodawater,
/turf/open/floor/corsat/squares,
/area/prisonru/research)
"Ox" = (
/obj/structure/machinery/cm_vending/sorted/medical/wall_med/limited{
	pixel_y = 28
	},
/turf/open/floor/hybrisa/tile/tilewhitecheckered/blue,
/area/prisonru/station/toilet/research)
"OC" = (
/obj/structure/pipes/standard/simple/hidden/dark,
/turf/open/floor/almayer/blackcorner/east,
/area/prisonru/research)
"Pu" = (
/obj/structure/disposalpipe/segment{
	dir = 8;
	icon_state = "pipe-c"
	},
/obj/structure/pipes/standard/manifold/fourway/hidden/cyan{
	color = "#a6aeab"
	},
/turf/open/floor/almayer/black/west,
/area/prisonru/research)
"PE" = (
/obj/structure/closet/crate/freezer,
/obj/item/reagent_container/food/snacks/meat/fish,
/obj/item/reagent_container/food/snacks/meat/fish,
/obj/item/reagent_container/food/snacks/meat/fish,
/obj/item/reagent_container/food/snacks/meat/fish,
/turf/open/floor/hybrisa/tile/tileblackcheckered,
/area/prisonru/research)
"Qq" = (
/obj/structure/sign/safety/coffee{
	pixel_y = -9
	},
/turf/closed/wall/prison,
/area/prisonru/station/toilet/research)
"Rg" = (
/obj/effect/decal/cleanable/dirt,
/turf/closed/wall/prison,
/area/prisonru/research)
"Ri" = (
/obj/structure/pipes/standard/manifold/hidden/dark{
	dir = 4
	},
/obj/structure/disposalpipe/segment,
/turf/open/floor/corsat/squares,
/area/prisonru/research)
"Rl" = (
/obj/structure/pipes/standard/simple/hidden/dark,
/obj/structure/disposalpipe/segment,
/turf/open/floor/almayer/black/west,
/area/prisonru/research)
"RG" = (
/turf/closed/wall/prison,
/area/prisonru/research)
"RI" = (
/obj/structure/flora/pottedplant{
	icon_state = "pottedplant_21";
	pixel_y = 16
	},
/turf/open/floor/almayer/black/north,
/area/prisonru/research)
"RP" = (
/obj/structure/pipes/standard/simple/hidden/dark{
	dir = 4
	},
/obj/structure/machinery/door/airlock/almayer/medical/glass/colony{
	name = "Research Dorms"
	},
/turf/open/floor/almayer/blackfull/west,
/area/prisonru/station/quarters/research)
"Sc" = (
/obj/structure/pipes/standard/simple/hidden/dark{
	dir = 4
	},
/obj/structure/inflatable/door,
/turf/open/floor/prison/whitepurple,
/area/prisonru/station/quarters/research)
"Td" = (
/obj/structure/sign/safety/coffee,
/turf/closed/wall/prison,
/area/prisonru/research)
"Tw" = (
/obj/effect/decal/cleanable/generic,
/turf/open/floor/almayer/black/east,
/area/prisonru/research)
"TD" = (
/obj/structure/machinery/vending/coffee{
	pixel_x = 8;
	density = 0
	},
/turf/open/floor/almayer/blackfull/west,
/area/prisonru/research)
"TO" = (
/obj/structure/machinery/power/apc/no_power/west,
/turf/open/floor/almayer/black/southwest,
/area/prisonru/research)
"Ul" = (
/obj/structure/filingcabinet{
	pixel_x = -15;
	density = 0
	},
/turf/open/floor/almayer/black/northwest,
/area/prisonru/research)
"Uq" = (
/obj/structure/closet/firecloset,
/turf/open/floor/almayer/black/southwest,
/area/prisonru/research)
"UU" = (
/obj/structure/sign/poster/safety{
	pixel_y = -25
	},
/turf/open/floor/hybrisa/tile/tileblackcheckered,
/area/prisonru/research)
"VJ" = (
/obj/structure/machinery/space_heater/radiator/red{
	dir = 4;
	pixel_x = -1
	},
/obj/structure/prop/hybrisa/misc/machinery/screens/redalert{
	light_color = "#FF0000";
	light_on = 1;
	light_power = 3;
	light_range = 5;
	pixel_x = -32
	},
/turf/open/floor/almayer/black/west,
/area/prisonru/research)
"VY" = (
/obj/structure/pipes/standard/simple/hidden/dark,
/obj/structure/disposalpipe/segment,
/turf/open/floor/almayer/blackfull/west,
/area/prisonru/research)
"WZ" = (
/obj/structure/sign/poster{
	desc = "Eat an EAT bar! ...Aren't they called MEAT bars?";
	icon_state = "poster7";
	name = "EAT - poster";
	pixel_y = 34
	},
/obj/structure/sink/kitchen{
	pixel_y = 15
	},
/turf/open/floor/hybrisa/tile/tileblackcheckered,
/area/prisonru/research)
"XI" = (
/obj/item/clothing/suit/chef/classic,
/obj/structure/surface/table/reinforced/prison{
	dir = 1;
	color = "#8e98a0"
	},
/obj/structure/machinery/reagentgrinder{
	pixel_y = 4;
	pixel_x = 5
	},
/turf/open/floor/hybrisa/tile/tileblackcheckered,
/area/prisonru/research)
"XO" = (
/obj/structure/pipes/standard/simple/hidden/dark{
	dir = 4
	},
/obj/effect/landmark/hunter_primary,
/turf/open/floor/almayer/blackfull/west,
/area/prisonru/research)
"XR" = (
/obj/effect/decal/siding{
	icon_state = "siding2"
	},
/obj/structure/barricade/handrail/wire{
	layer = 3.1
	},
/turf/open/floor/corsat/squares,
/area/prisonru/research)
"XY" = (
/obj/structure/pipes/standard/simple/hidden/dark,
/turf/open/floor/almayer/blackfull/west,
/area/prisonru/research)
"Yf" = (
/obj/structure/pipes/vents/pump{
	dir = 4
	},
/obj/item/ammo_casing/bullet,
/turf/open/floor/almayer/black,
/area/prisonru/research)
"Yw" = (
/obj/structure/pipes/vents/pump{
	dir = 1
	},
/turf/open/floor/almayer/blackfull/west,
/area/prisonru/research)

(1,1,1) = {"
FH
FH
FH
FH
FH
FH
Cl
Ly
Cl
Cl
IO
aG
oi
pS
qv
"}
(2,1,1) = {"
Lm
Ul
Gz
VJ
uv
Dq
ev
lu
TO
Cl
CY
as
xH
Uq
qv
"}
(3,1,1) = {"
bW
LY
VY
wh
VY
re
mS
Ri
cW
Cl
KE
JN
Yw
Fl
qv
"}
(4,1,1) = {"
xH
MA
xH
EL
Op
Lp
iI
Lg
LW
Cl
qM
as
xH
ns
qv
"}
(5,1,1) = {"
Lm
IN
do
xE
ax
co
Ka
xH
um
Cl
Td
aG
CZ
pS
qv
"}
(6,1,1) = {"
RG
ag
IS
EL
kX
rf
nA
do
yV
Rl
Rl
Pu
jx
lM
ad
"}
(7,1,1) = {"
Fw
MA
do
AJ
pV
ho
Ka
IS
fN
xH
yM
XO
xH
Yf
XR
"}
(8,1,1) = {"
Fw
RI
xH
Lg
Hq
do
dT
XY
DS
Tw
kZ
tg
OC
lJ
yz
"}
(9,1,1) = {"
RG
gi
qO
kZ
kZ
fO
aa
kZ
No
TD
eD
qF
Cg
eY
xH
"}
(10,1,1) = {"
RG
RG
bn
nL
xn
Rg
tm
Rg
Dy
Dy
Dy
Dy
Dy
RP
EQ
"}
(11,1,1) = {"
RG
WZ
LX
LX
GZ
Ab
ab
hv
Dy
La
Dy
La
Qq
vL
NC
"}
(12,1,1) = {"
Cl
xI
LX
xa
iM
kU
LX
UU
Dy
Gf
Dy
Gf
Dy
bc
gM
"}
(13,1,1) = {"
Cl
GF
Bv
XI
sk
PE
pK
JT
Dy
Hn
AU
gl
Dy
Sc
bK
"}
(14,1,1) = {"
tY
tY
tY
tY
tY
tY
tY
tY
oX
Ox
fX
cp
Ns
Iq
HH
"}

(1,1,2) = {"
ac
ac
ac
ac
ac
ac
ac
ac
ac
ac
ac
ac
ac
ac
eS
"}
(2,1,2) = {"
ac
ac
ac
ac
ac
ac
ac
ac
ac
ac
ac
ac
ac
ac
eS
"}
(3,1,2) = {"
ac
ac
ac
ac
ac
ac
ac
ac
ac
ac
ac
ac
ac
ac
eS
"}
(4,1,2) = {"
ac
ac
ac
ac
ac
ac
ac
ac
ac
ac
ac
ac
ac
ac
eS
"}
(5,1,2) = {"
ac
ac
ac
ac
ac
ac
ac
ac
ac
ac
ac
ac
ac
ac
eS
"}
(6,1,2) = {"
ac
ac
ac
ac
ac
ac
ac
ac
ac
ac
ac
ac
ac
ac
ac
"}
(7,1,2) = {"
ac
ac
ac
ac
ac
ac
ac
ac
ac
ac
ac
ac
ac
ac
ac
"}
(8,1,2) = {"
ac
ac
ac
ac
ac
ac
ac
ac
ac
ac
ac
ac
ac
ac
ac
"}
(9,1,2) = {"
ac
ac
ac
ac
ac
ac
ac
ac
ac
ac
ac
ac
ac
ac
ac
"}
(10,1,2) = {"
ac
ac
ac
ac
ac
ac
ac
ac
ac
ac
ac
ac
ac
ac
ac
"}
(11,1,2) = {"
ac
ac
ac
ac
ac
ac
ac
ac
ac
ac
ac
ac
ac
ac
ac
"}
(12,1,2) = {"
ac
ac
ac
ac
ac
ac
ac
ac
ac
ac
ac
ac
ac
ac
ac
"}
(13,1,2) = {"
ac
ac
ac
ac
ac
ac
ac
ac
ac
ac
ac
ac
ac
ac
ac
"}
(14,1,2) = {"
ac
ac
ac
ac
ac
ac
ac
ac
ac
ac
ac
ac
ac
ac
ac
"}
