//MAP CONVERTED BY dmm2tgm.py THIS HEADER COMMENT PREVENTS RECONVERSION, DO NOT REMOVE
"a" = (
/turf/open/auto_turf/snow/brown_base/layer1,
/area/bigredv2/outside/space_port_lz2)
"b" = (
/obj/docking_port/stationary/marine_dropship/lz2{
	name = "LZ2: Engineering Landing Zone";
	faction = "Yautja"
	},
/turf/open/auto_turf/snow/brown_base/layer1,
/area/bigredv2/outside/space_port_lz2)
"v" = (
/obj/effect/landmark/hunter_primary,
/turf/open/auto_turf/snow/brown_base/layer1,
/area/bigredv2/outside/space_port_lz2)

(1,1,1) = {"
a
v
a
"}
(2,1,1) = {"
a
b
a
"}
(3,1,1) = {"
a
a
a
"}
