//MAP CONVERTED BY dmm2tgm.py THIS HEADER COMMENT PREVENTS RECONVERSION, DO NOT REMOVE
"aa" = (
/obj/structure/interior_wall/apc{
	icon_state = "rear_6"
	},
/turf/open/void/vehicle,
/area/space)
"ab" = (
/obj/structure/interior_wall/apc{
	icon_state = "wheel_back_top_1";
	pixel_x = -4;
	pixel_y = -4
	},
/turf/open/void/vehicle,
/area/space)
"ac" = (
/obj/structure/interior_wall/apc{
	icon_state = "corner_small_L";
	opacity = 0
	},
/obj/structure/interior_wall/apc{
	icon_state = "wheel_back_top_2";
	pixel_x = -4;
	pixel_y = -4
	},
/turf/open/void/vehicle,
/area/space)
"ad" = (
/obj/structure/interior_wall/apc{
	icon_state = "wall"
	},
/turf/open/void/vehicle,
/area/space)
"ae" = (
/obj/structure/interior_wall/apc{
	icon_state = "door_back"
	},
/turf/open/void/vehicle,
/area/space)
"ag" = (
/obj/structure/interior_wall/apc{
	icon_state = "corner_small_R";
	opacity = 0
	},
/obj/structure/interior_wall/apc{
	icon_state = "wheel_front_top_2";
	pixel_x = 4;
	pixel_y = -4
	},
/turf/open/void/vehicle,
/area/space)
"ah" = (
/obj/structure/interior_wall/apc{
	icon_state = "wheel_front_top_1";
	pixel_x = 1;
	pixel_y = -4
	},
/turf/open/void/vehicle,
/area/space)
"ai" = (
/obj/structure/interior_wall/apc{
	icon_state = "front_6"
	},
/turf/open/void/vehicle,
/area/space)
"aj" = (
/obj/structure/interior_wall/apc{
	icon_state = "corner_small_L"
	},
/obj/structure/interior_wall/apc{
	icon_state = "rear_5"
	},
/turf/open/void/vehicle,
/area/space)
"ak" = (
/obj/structure/interior_wall/apc{
	icon_state = "wall";
	opacity = 0
	},
/turf/open/void/vehicle,
/area/space)
"al" = (
/obj/structure/interior_wall/apc{
	icon_state = "corner_inverse_L";
	opacity = 0
	},
/turf/open/void/vehicle,
/area/space)
"am" = (
/obj/structure/vehicle_locker{
	pixel_y = 28
	},
/obj/effect/landmark/interior/spawn/vehicle_gunner_seat/armor{
	dir = 4
	},
/turf/open/shuttle/vehicle/floor_3_8_1,
/area/interior/vehicle/apc)
"an" = (
/obj/structure/interior_wall/apc{
	icon_state = "corner_inverse_R";
	opacity = 0
	},
/turf/open/void/vehicle,
/area/space)
"ao" = (
/obj/structure/interior_wall/apc{
	icon_state = "corner_small_R"
	},
/obj/structure/interior_wall/apc{
	icon_state = "front_5"
	},
/turf/open/void/vehicle,
/area/space)
"ap" = (
/obj/structure/interior_wall/apc{
	icon_state = "rear_4"
	},
/turf/open/void/vehicle,
/area/space)
"aq" = (
/obj/structure/interior_wall/apc{
	icon_state = "front_4"
	},
/turf/open/void/vehicle,
/area/space)
"ar" = (
/obj/structure/interior_wall/apc{
	icon_state = "rear_3"
	},
/turf/open/void/vehicle,
/area/space)
"as" = (
/obj/structure/interior_wall/apc{
	icon_state = "front_3"
	},
/turf/open/void/vehicle,
/area/space)
"at" = (
/obj/structure/interior_wall/apc{
	icon_state = "rear_2"
	},
/turf/open/void/vehicle,
/area/space)
"au" = (
/obj/structure/interior_wall/apc{
	icon_state = "front_2"
	},
/turf/open/void/vehicle,
/area/space)
"av" = (
/obj/structure/interior_wall/apc{
	icon_state = "rear_1"
	},
/turf/open/void/vehicle,
/area/space)
"aw" = (
/obj/structure/interior_wall/apc{
	icon_state = "rear_wheel_L"
	},
/turf/open/space/basic,
/area/space)
"ax" = (
/obj/structure/interior_wall/apc{
	icon_state = "rear_wheel_R";
	opacity = 0
	},
/turf/open/space/basic,
/area/space)
"ay" = (
/obj/structure/barricade/handrail/medical,
/obj/structure/surface/table/reinforced/prison,
/obj/item/device/defibrillator,
/obj/structure/machinery/recharger,
/obj/structure/barricade/handrail/medical{
	dir = 4;
	pixel_x = 2
	},
/obj/effect/decal/medical_decals/permanent{
	icon_state = "triagedecalbottom"
	},
/obj/effect/decal/medical_decals/permanent{
	icon_state = "triagedecaltopright"
	},
/turf/open/shuttle/vehicle/dark_sterile_green_14,
/area/interior/vehicle/apc)
"az" = (
/obj/effect/landmark/interior/spawn/interior_camera{
	dir = 10;
	pixel_x = -14;
	pixel_y = 38
	},
/obj/structure/machinery/medical_pod/autodoc/unskilled{
	name = "\improper autodoc emergency medical system"
	},
/obj/structure/barricade/handrail/medical{
	dir = 4;
	pixel_x = 2
	},
/obj/structure/barricade/handrail/medical{
	dir = 1
	},
/obj/effect/decal/medical_decals/permanent{
	icon_state = "triagedecaltop";
	pixel_y = -2
	},
/obj/effect/decal/medical_decals/permanent{
	icon_state = "triagedecalbottomright"
	},
/turf/open/shuttle/vehicle/med,
/area/interior/vehicle/apc)
"aA" = (
/obj/structure/interior_wall/apc{
	icon_state = "front_wheel_L";
	opacity = 0
	},
/turf/open/space/basic,
/area/space)
"aB" = (
/obj/structure/interior_wall/apc{
	icon_state = "front_wheel_R"
	},
/turf/open/space/basic,
/area/space)
"aC" = (
/obj/structure/interior_wall/apc{
	icon_state = "front_1"
	},
/turf/open/void/vehicle,
/area/space)
"aD" = (
/turf/open/void/vehicle,
/area/space)
"aE" = (
/obj/structure/bed/chair/vehicle{
	pixel_x = -8
	},
/obj/structure/bed/chair/vehicle{
	pixel_x = 8
	},
/obj/structure/extinguisher_cabinet/lifeboat{
	icon = 'icons/obj/vehicles/interiors/general.dmi';
	pixel_x = 18;
	pixel_y = 28
	},
/obj/structure/transmitter{
	pixel_x = 7;
	pixel_y = 30;
	phone_id = "M888 Armored Personnel Carrier";
	name = "APC Telephone";
	icon = 'icons/obj/vehicles/interiors/general.dmi';
	phone_category = "Vehicles"
	},
/obj/structure/machinery/computer/supply/tent{
	pixel_y = 28;
	pixel_x = -6
	},
/turf/open/shuttle/vehicle/floor_3_13,
/area/interior/vehicle/apc)
"aF" = (
/obj/effect/landmark/interior/spawn/vehicle_support_gunner_seat{
	dir = 1
	},
/obj/structure/prop/vehicle/firing_port_weapon{
	dir = 1;
	name = "Left M56 FPW handle";
	pixel_y = 17
	},
/turf/open/shuttle/vehicle/floor_3,
/area/interior/vehicle/apc)
"aH" = (
/obj/effect/landmark/interior/spawn/weapons_loader,
/turf/open/shuttle/vehicle/floor_3_6,
/area/interior/vehicle/apc)
"aK" = (
/obj/effect/landmark/interior/spawn/interior_viewport{
	pixel_x = -6;
	pixel_y = 23
	},
/obj/structure/machinery/optable,
/turf/open/shuttle/vehicle/med,
/area/interior/vehicle/apc)
"aL" = (
/obj/structure/machinery/cm_vending/sorted/medical/blood/vehicle{
	pixel_x = -20;
	pixel_y = 23
	},
/obj/structure/machinery/cm_vending/sorted/medical/vehicle{
	pixel_x = 2;
	pixel_y = 23
	},
/obj/structure/machinery/autodoc_console{
	upgrades = list(1, 2, 3, 4);
	desc = "The control interface used to operate the adjoining autodoc. Requires training to use properly. That one has multiple advanced operations already included!";
	dir = 1
	},
/obj/effect/decal/medical_decals/permanent{
	icon_state = "triagedecaltopright"
	},
/turf/open/shuttle/vehicle/med,
/area/interior/vehicle/apc)
"aO" = (
/obj/effect/landmark/interior/spawn/entrance{
	alpha = 50;
	dir = 1;
	exit_type = /obj/structure/interior_exit/vehicle/apc;
	name = "Left APC door";
	pixel_y = 32;
	tag = "left"
	},
/obj/effect/landmark/interior/spawn/interior_viewport{
	dir = 8;
	pixel_x = 5;
	pixel_y = 8
	},
/turf/open/shuttle/vehicle/floor_1_11,
/area/interior/vehicle/apc)
"aP" = (
/obj/structure/machinery/iv_drip,
/obj/structure/machinery/prop/almayer/CICmap/computer{
	dir = 4;
	layer = 3.21;
	pixel_x = -14;
	pixel_y = 4
	},
/obj/structure/machinery/computer/groundside_operations/arc{
	dir = 4;
	layer = 3.22;
	pixel_x = -14;
	pixel_y = -9
	},
/obj/structure/barricade/handrail/medical,
/obj/effect/decal/medical_decals/permanent{
	icon_state = "triagedecalbottom"
	},
/turf/open/shuttle/vehicle/dark_sterile_green_5,
/area/interior/vehicle/apc)
"aQ" = (
/obj/effect/decal/medical_decals/permanent{
	icon_state = "triagedecalbottom"
	},
/turf/open/shuttle/vehicle/dark_sterile_green_5,
/area/interior/vehicle/apc)
"aS" = (
/turf/open/shuttle/vehicle/floor_1_14,
/area/interior/vehicle/apc)
"aU" = (
/turf/open/shuttle/vehicle/floor_1_6,
/area/interior/vehicle/apc)
"aV" = (
/obj/structure/machinery/computer/overwatch/almayer/small{
	dir = 4;
	layer = 3.23;
	pixel_x = -14;
	pixel_y = 10
	},
/obj/structure/machinery/computer/intel/disk_reader{
	dir = 4;
	layer = 3.24;
	pixel_x = -14;
	pixel_y = -3
	},
/obj/structure/bed/chair/comfy{
	dir = 8
	},
/obj/structure/machinery/computer/view_objectives{
	dir = 4;
	pixel_x = -14;
	pixel_y = -16;
	layer = 3.25;
	icon = 'icons/obj/vehicles/interiors/arc.dmi';
	icon_state = "cicmap_computer"
	},
/turf/open/shuttle/vehicle/floor_1_13,
/area/interior/vehicle/apc)
"aW" = (
/turf/open/shuttle/vehicle/floor_1_5,
/area/interior/vehicle/apc)
"aX" = (
/obj/effect/landmark/interior/spawn/vehicle_support_gunner_seat/second,
/obj/structure/prop/vehicle/firing_port_weapon{
	layer = 4.1;
	name = "Right M56 FPW handle";
	pixel_y = 2
	},
/turf/open/shuttle/vehicle/floor_3,
/area/interior/vehicle/apc)
"aY" = (
/obj/effect/landmark/interior/spawn/vehicle_driver_seat/armor{
	dir = 4
	},
/turf/open/shuttle/vehicle/floor_3_9_1,
/area/interior/vehicle/apc)
"ba" = (
/obj/effect/landmark/interior/spawn/entrance{
	alpha = 50;
	exit_type = /obj/structure/interior_exit/vehicle/apc;
	name = "Right APC door";
	tag = "right"
	},
/obj/effect/landmark/interior/spawn/interior_viewport{
	dir = 8;
	pixel_x = 5;
	pixel_y = 1
	},
/turf/open/shuttle/vehicle/floor_1_12,
/area/interior/vehicle/apc)
"bc" = (
/obj/structure/bed/chair/vehicle{
	dir = 1;
	pixel_x = 8
	},
/obj/structure/bed/chair/vehicle{
	dir = 1;
	pixel_x = -8
	},
/turf/open/shuttle/vehicle/floor_3_13,
/area/interior/vehicle/apc)
"bd" = (
/obj/structure/interior_wall/apc{
	alpha = 100;
	icon_state = "door_front";
	layer = 5.2;
	pixel_y = 32
	},
/turf/open/void/vehicle,
/area/space)
"be" = (
/obj/structure/interior_wall/apc{
	alpha = 100;
	icon_state = "wall_door_front";
	layer = 5.2;
	pixel_y = 32
	},
/turf/open/void/vehicle,
/area/space)
"Ty" = (
/turf/open/shuttle/vehicle/floor_1_3_3,
/area/interior/vehicle/apc)

(1,1,1) = {"
aa
aj
ap
ar
at
av
aD
"}
(2,1,1) = {"
ab
ak
aK
aP
aV
aw
aD
"}
(3,1,1) = {"
ac
al
aL
aQ
aW
ax
aD
"}
(4,1,1) = {"
ad
aF
az
ay
aS
aX
be
"}
(5,1,1) = {"
ae
aO
aU
Ty
aU
ba
bd
"}
(6,1,1) = {"
ag
an
aE
aS
bc
aA
aD
"}
(7,1,1) = {"
ah
ak
am
aH
aY
aB
aD
"}
(8,1,1) = {"
ai
ao
aq
as
au
aC
aD
"}
