//MAP CONVERTED BY dmm2tgm.py THIS HEADER COMMENT PREVENTS RECONVERSION, DO NOT REMOVE
"ac" = (
/obj/effect/landmark/hunter_primary,
/turf/open/auto_turf/snow/brown_base/layer1,
/area/lv624/ground/barrens/south_west_barrens)
"ae" = (
/obj/structure/flora/bush/ausbushes/grassybush,
/turf/open/ice/noweed,
/area/lv624/ground/river/west_river)
"af" = (
/obj/effect/landmark/lv624/fog_blocker,
/turf/open/ice/noweed,
/area/lv624/ground/river/west_river)
"ag" = (
/obj/effect/alien/weeds/node,
/obj/structure/flora/bush/ausbushes/grassybush,
/turf/open/auto_turf/snow/brown_base/layer1,
/area/lv624/ground/barrens/south_west_barrens)
"ah" = (
/obj/structure/flora/jungle/alienplant1,
/obj/effect/landmark/lv624/fog_blocker,
/turf/open/ice/noweed,
/area/lv624/ground/river/west_river)
"ai" = (
/obj/structure/flora/bush/ausbushes/var3/fullgrass,
/turf/open/auto_turf/snow/brown_base/layer1,
/area/lv624/ground/river/west_river)
"aj" = (
/obj/structure/flora/bush/ausbushes/ywflowers,
/turf/open/ice/noweed,
/area/lv624/ground/river/west_river)
"al" = (
/obj/structure/flora/bush/ausbushes/palebush,
/turf/open/ice/noweed,
/area/lv624/ground/river/west_river)
"am" = (
/obj/structure/flora/bush/ausbushes/var3/sunnybush,
/turf/open/ice/noweed,
/area/lv624/ground/river/west_river)
"aC" = (
/obj/structure/flora/jungle/vines/light_2,
/turf/open/auto_turf/snow/brown_base/layer1,
/area/lv624/ground/jungle/west_jungle)
"aD" = (
/obj/structure/flora/jungle/vines/light_1,
/turf/open/auto_turf/snow/brown_base/layer1,
/area/lv624/ground/jungle/west_jungle)
"aE" = (
/turf/open/auto_turf/snow/brown_base/layer1,
/area/lv624/ground/jungle/west_jungle)
"aU" = (
/turf/closed/wall/strata_ice/jungle,
/area/lv624/ground/river/west_river)
"bc" = (
/turf/open/ice/noweed,
/area/lv624/ground/river/west_river)
"bf" = (
/obj/structure/flora/bush/ausbushes/grassybush,
/turf/open/auto_turf/snow/brown_base/layer1,
/area/lv624/ground/barrens/south_west_barrens)
"bh" = (
/obj/structure/flora/bush/ausbushes/reedbush,
/turf/open/auto_turf/snow/brown_base/layer1,
/area/lv624/ground/barrens/south_west_barrens)
"bi" = (
/turf/open/auto_turf/snow/brown_base/layer1,
/area/lv624/ground/barrens/south_west_barrens)
"bx" = (
/obj/effect/alien/weeds/node,
/turf/open/auto_turf/snow/brown_base/layer1,
/area/lv624/ground/barrens/south_west_barrens)
"bN" = (
/obj/structure/flora/bush/ausbushes/var3/fullgrass,
/turf/open/ice/noweed,
/area/lv624/ground/river/west_river)
"gX" = (
/turf/closed/wall/rock/brown,
/area/lv624/ground/river/west_river)
"qG" = (
/obj/structure/flora/bush/ausbushes/reedbush,
/turf/open/auto_turf/snow/brown_base/layer1,
/area/lv624/ground/river/west_river)
"ve" = (
/obj/structure/flora/bush/ausbushes/reedbush,
/turf/open/ice/noweed,
/area/lv624/ground/jungle/west_jungle)
"Dw" = (
/turf/closed/wall/strata_ice/jungle,
/area/lv624/ground/jungle/west_jungle)
"ES" = (
/turf/open/auto_turf/snow/brown_base/layer1,
/area/lv624/ground/river/west_river)
"FJ" = (
/obj/structure/flora/bush/ausbushes/reedbush,
/turf/open/ice/noweed,
/area/lv624/ground/river/west_river)
"JC" = (
/turf/closed/wall/rock/brown,
/area/lv624/ground/caves/south_west_caves)
"KD" = (
/turf/open/ice/noweed,
/area/lv624/ground/jungle/west_jungle)
"Ok" = (
/obj/structure/flora/jungle/alienplant1,
/turf/open/ice/noweed,
/area/lv624/ground/river/west_river)
"Oz" = (
/turf/closed/wall/rock/brown,
/area/lv624/ground/barrens/south_west_barrens)
"VA" = (
/obj/effect/alien/weeds/node,
/turf/open/auto_turf/snow/brown_base/layer1,
/area/lv624/ground/river/west_river)
"Za" = (
/turf/closed/wall/rock/brown,
/area/lv624/ground/jungle/west_jungle)

(1,1,1) = {"
JC
JC
JC
JC
Oz
Oz
gX
aU
aU
aU
aU
Dw
Dw
"}
(2,1,1) = {"
JC
JC
JC
JC
bi
bi
ES
ES
VA
ES
ES
aE
aC
"}
(3,1,1) = {"
JC
JC
bi
bi
ag
bi
ES
ES
ES
ES
qG
aE
aD
"}
(4,1,1) = {"
JC
bi
bh
bi
bi
bi
ai
ES
ES
ES
ES
aE
aE
"}
(5,1,1) = {"
JC
bi
bi
bi
ES
ES
ES
bc
bc
ES
aE
aE
aE
"}
(6,1,1) = {"
bi
bi
bi
bi
ES
bc
aj
bc
bc
ES
aE
Za
aE
"}
(7,1,1) = {"
bi
bi
bx
bi
ES
bc
bc
Ok
FJ
ES
aE
Za
aE
"}
(8,1,1) = {"
bi
bi
bh
bi
ES
bc
bc
bc
am
ES
aE
aE
aE
"}
(9,1,1) = {"
bx
bi
bi
ES
ES
bc
bc
bc
bc
ES
aE
aE
aE
"}
(10,1,1) = {"
bf
bi
ac
ES
bc
Ok
al
bc
ES
ES
aE
aE
aE
"}
(11,1,1) = {"
bi
ES
ES
ES
bc
bN
bc
bc
ES
aE
aE
aE
aE
"}
(12,1,1) = {"
bi
ES
bc
bc
bc
bc
bN
bc
ES
aE
aE
aE
aE
"}
(13,1,1) = {"
bx
ES
ae
bc
bc
bc
bc
bc
bc
ve
aE
aE
aE
"}
(14,1,1) = {"
bi
ES
af
af
af
ah
af
af
KD
KD
aE
aE
aE
"}
