//MAP CONVERTED BY dmm2tgm.py THIS HEADER COMMENT PREVENTS RECONVERSION, DO NOT REMOVE
"ab" = (
/turf/open/auto_turf/snow/brown_base/layer1,
/area/lv624/ground/barrens/central_barrens)
"ac" = (
/obj/effect/landmark/lv624/fog_blocker,
/obj/structure/fence,
/turf/open/floor/plating/warnplate/northwest,
/area/lv624/ground/barrens/central_barrens)
"ad" = (
/turf/open/floor/plating/asteroidwarning/north,
/area/lv624/ground/barrens/central_barrens)
"ae" = (
/obj/effect/landmark/lv624/fog_blocker,
/obj/structure/fence,
/turf/open/floor/plating/warnplate/northeast,
/area/lv624/ground/barrens/central_barrens)
"aj" = (
/obj/structure/flora/bush/ausbushes/reedbush,
/turf/open/auto_turf/snow/brown_base/layer1,
/area/lv624/ground/barrens/central_barrens)
"ak" = (
/obj/structure/flora/bush/ausbushes/reedbush,
/obj/effect/landmark/lv624/fog_blocker,
/turf/open/auto_turf/snow/brown_base/layer1,
/area/lv624/ground/river/central_river)
"al" = (
/obj/effect/landmark/lv624/fog_blocker,
/obj/structure/fence,
/turf/open/floor/plating/warnplate/west,
/area/lv624/ground/river/central_river)
"am" = (
/turf/open/floor/plating/asteroidfloor/north,
/area/lv624/ground/river/central_river)
"as" = (
/obj/structure/flora/bush/ausbushes/var3/stalkybush,
/turf/open/ice/noweed,
/area/lv624/ground/river/central_river)
"au" = (
/obj/effect/landmark/lv624/fog_blocker,
/obj/structure/fence,
/turf/open/floor/plating/warnplate/east,
/area/lv624/ground/river/central_river)
"av" = (
/obj/effect/landmark/crap_item,
/obj/effect/landmark/lv624/fog_blocker,
/turf/open/auto_turf/snow/brown_base/layer1,
/area/lv624/ground/river/central_river)
"aw" = (
/obj/structure/flora/bush/ausbushes/reedbush,
/obj/effect/landmark/lv624/fog_blocker,
/obj/effect/landmark/lv624/fog_blocker,
/turf/open/ice/noweed,
/area/lv624/ground/river/central_river)
"ay" = (
/obj/effect/landmark/crap_item,
/turf/open/ice/noweed,
/area/lv624/ground/river/central_river)
"az" = (
/obj/effect/landmark/lv624/fog_blocker,
/turf/open/ice/noweed,
/area/lv624/ground/river/central_river)
"aA" = (
/obj/structure/flora/bush/ausbushes/var3/brflowers,
/turf/open/ice/noweed,
/area/lv624/ground/river/central_river)
"aE" = (
/obj/structure/flora/bush/ausbushes/genericbush,
/turf/open/auto_turf/snow/brown_base/layer1,
/area/lv624/ground/river/central_river)
"aF" = (
/obj/effect/landmark/crap_item,
/obj/effect/landmark/lv624/fog_blocker,
/turf/open/ice/noweed,
/area/lv624/ground/river/central_river)
"aI" = (
/obj/structure/flora/jungle/alienplant1,
/obj/effect/landmark/lv624/fog_blocker,
/turf/open/ice/noweed,
/area/lv624/ground/river/central_river)
"aK" = (
/turf/open/ice/noweed,
/area/lv624/ground/river/central_river)
"aL" = (
/obj/effect/landmark/lv624/fog_blocker,
/turf/open/auto_turf/snow/brown_base/layer1,
/area/lv624/ground/barrens/central_barrens)
"aO" = (
/obj/structure/fence,
/turf/open/floor/plating/warnplate/southwest,
/area/lv624/ground/river/central_river)
"aQ" = (
/obj/structure/flora/bush/ausbushes/reedbush,
/turf/open/ice/noweed,
/area/lv624/ground/river/central_river)
"aV" = (
/obj/structure/flora/jungle/plantbot1,
/turf/open/auto_turf/snow/brown_base/layer1,
/area/lv624/ground/river/central_river)
"aW" = (
/turf/open/floor/plating/asteroidwarning,
/area/lv624/ground/river/central_river)
"aX" = (
/obj/structure/fence,
/turf/open/floor/plating/warnplate/southeast,
/area/lv624/ground/river/central_river)
"bf" = (
/turf/open/auto_turf/snow/brown_base/layer1,
/area/lv624/ground/river/central_river)
"bq" = (
/obj/structure/machinery/colony_floodlight,
/turf/open/auto_turf/snow/brown_base/layer1,
/area/lv624/ground/jungle/north_jungle)
"bD" = (
/obj/effect/landmark/lv624/fog_blocker,
/turf/closed/wall/strata_ice/jungle,
/area/lv624/ground/jungle/north_jungle)
"bE" = (
/obj/effect/landmark/monkey_spawn,
/turf/open/auto_turf/snow/brown_base/layer1,
/area/lv624/ground/jungle/north_jungle)
"bK" = (
/obj/effect/landmark/lv624/fog_blocker,
/turf/open/auto_turf/snow/brown_base/layer1,
/area/lv624/ground/jungle/north_jungle)
"bN" = (
/turf/open/auto_turf/snow/brown_base/layer1,
/area/lv624/ground/jungle/north_jungle)
"cp" = (
/obj/structure/flora/jungle/alienplant1,
/turf/open/auto_turf/snow/brown_base/layer1,
/area/lv624/ground/river/central_river)
"pW" = (
/obj/structure/flora/bush/ausbushes/var3/fullgrass,
/turf/open/ice/noweed,
/area/lv624/ground/river/central_river)
"uC" = (
/obj/structure/flora/bush/ausbushes/var3/brflowers,
/turf/open/auto_turf/snow/brown_base/layer1,
/area/lv624/ground/river/central_river)
"wp" = (
/obj/structure/flora/bush/ausbushes/var3/fullgrass,
/turf/open/auto_turf/snow/brown_base/layer1,
/area/lv624/ground/river/central_river)
"wu" = (
/obj/structure/flora/jungle/alienplant1,
/turf/open/ice/noweed,
/area/lv624/ground/river/central_river)
"Bv" = (
/obj/effect/landmark/good_item,
/turf/open/floor/plating/asteroidfloor/north,
/area/lv624/ground/river/central_river)
"BA" = (
/obj/structure/flora/bush/ausbushes/genericbush,
/turf/open/auto_turf/snow/brown_base/layer1,
/area/lv624/ground/jungle/north_jungle)
"DQ" = (
/obj/structure/flora/bush/ausbushes/reedbush,
/turf/open/auto_turf/snow/brown_base/layer1,
/area/lv624/ground/river/central_river)
"Ex" = (
/turf/closed/wall/strata_ice/jungle,
/area/lv624/ground/jungle/north_jungle)
"GU" = (
/obj/effect/landmark/crap_item,
/turf/open/floor/plating/asteroidfloor/north,
/area/lv624/ground/river/central_river)
"Hi" = (
/obj/structure/flora/jungle/plantbot1,
/turf/open/auto_turf/snow/brown_base/layer1,
/area/lv624/ground/jungle/north_jungle)
"HT" = (
/obj/structure/flora/jungle/planttop1,
/turf/open/ice/noweed,
/area/lv624/ground/river/central_river)
"Ir" = (
/obj/structure/flora/bush/ausbushes/var3/ppflowers,
/turf/open/ice/noweed,
/area/lv624/ground/river/central_river)
"Jl" = (
/obj/effect/landmark/lv624/fog_blocker,
/turf/open/auto_turf/snow/brown_base/layer1,
/area/lv624/ground/river/central_river)
"Nc" = (
/obj/structure/flora/jungle/planttop1,
/turf/open/auto_turf/snow/brown_base/layer1,
/area/lv624/ground/river/central_river)
"Ow" = (
/obj/structure/flora/jungle/planttop1,
/obj/effect/landmark/lv624/fog_blocker,
/turf/open/auto_turf/snow/brown_base/layer1,
/area/lv624/ground/jungle/north_jungle)
"Rp" = (
/obj/structure/flora/jungle/planttop1,
/turf/open/auto_turf/snow/brown_base/layer1,
/area/lv624/ground/jungle/north_jungle)
"XY" = (
/obj/structure/fence,
/turf/open/floor/plating/warnplate/east,
/area/lv624/ground/river/central_river)
"YA" = (
/obj/structure/flora/jungle/plantbot1,
/turf/open/ice/noweed,
/area/lv624/ground/river/central_river)
"YL" = (
/obj/structure/fence,
/turf/open/floor/plating/warnplate/west,
/area/lv624/ground/river/central_river)

(1,1,1) = {"
ab
aj
Jl
Jl
Jl
aK
aK
bf
bN
bN
bK
bq
bN
bN
"}
(2,1,1) = {"
ab
ab
bf
bf
Jl
bf
DQ
bf
bf
bN
bK
bK
bN
bN
"}
(3,1,1) = {"
ab
ab
bf
bf
Jl
bf
bf
bf
bf
bf
bN
bK
bK
Ex
"}
(4,1,1) = {"
ab
ab
Jl
Jl
Jl
bf
bf
bf
Nc
aV
bf
bN
bK
Ex
"}
(5,1,1) = {"
ab
ak
Jl
aK
aK
wu
bf
bf
DQ
bf
bf
bN
bK
Ex
"}
(6,1,1) = {"
ab
Jl
az
aF
az
az
Jl
Jl
Jl
Jl
Jl
bK
bN
bN
"}
(7,1,1) = {"
ac
al
YL
YL
YL
YL
YL
YL
YL
YL
aO
Rp
Hi
bN
"}
(8,1,1) = {"
ad
am
am
am
am
am
am
am
am
GU
aW
bN
bN
bN
"}
(9,1,1) = {"
ad
am
am
am
am
am
am
am
am
am
aW
bN
bN
bN
"}
(10,1,1) = {"
ad
am
am
am
Bv
am
am
am
am
am
aW
bN
bN
bN
"}
(11,1,1) = {"
ae
au
au
XY
XY
XY
XY
XY
XY
XY
aX
bN
bN
bN
"}
(12,1,1) = {"
ab
aL
av
aI
az
az
az
az
aw
Jl
Jl
bK
bN
bN
"}
(13,1,1) = {"
ab
ab
Jl
aK
aK
aK
bf
bf
bf
bf
bf
Ow
Hi
bN
"}
(14,1,1) = {"
ab
ab
Jl
aK
aA
aK
bf
bf
bf
bf
bf
bN
bK
bN
"}
(15,1,1) = {"
Jl
Jl
Jl
aK
aK
aK
bf
cp
aK
aK
bf
bN
bD
bN
"}
(16,1,1) = {"
ak
aK
aK
aK
aK
bf
bf
bf
aK
aQ
bf
bN
bD
bN
"}
(17,1,1) = {"
Jl
aK
aK
aK
aK
aE
bf
bf
aQ
aK
bf
bK
bN
bN
"}
(18,1,1) = {"
Jl
Jl
aK
aK
aK
bf
bf
uC
bf
bf
bf
bK
bE
bN
"}
(19,1,1) = {"
ab
Jl
aK
aK
ay
bf
bf
bf
bf
bf
bf
bK
bN
bq
"}
(20,1,1) = {"
ab
Jl
aK
aK
aK
aK
aK
aK
aK
bf
bf
bK
bN
bN
"}
(21,1,1) = {"
Jl
Jl
aK
aK
aK
aK
aK
aK
aK
bf
bf
bK
BA
bN
"}
(22,1,1) = {"
Jl
as
aK
aK
aK
Ir
aK
aK
aK
wp
bf
bK
bN
bN
"}
(23,1,1) = {"
Jl
aK
aK
aK
aK
aK
aK
ay
aK
bf
bf
bK
bN
bN
"}
(24,1,1) = {"
Jl
aK
aK
aK
aK
aK
aK
aK
aK
bf
bf
bK
Ex
bN
"}
(25,1,1) = {"
Jl
aK
aK
aA
aK
wu
aK
aQ
aK
bf
bf
bK
bN
bN
"}
(26,1,1) = {"
Jl
aK
aK
aK
aK
aK
aK
aK
aK
bf
bf
bN
bK
bN
"}
(27,1,1) = {"
Jl
aK
aK
aK
aK
aK
aK
aK
aK
aK
bf
bN
bK
bq
"}
(28,1,1) = {"
Jl
aK
aK
aQ
aK
aK
aK
HT
YA
aK
bf
bN
bK
Ex
"}
(29,1,1) = {"
Jl
aK
aK
aK
aK
aK
aK
aK
aK
aK
bf
bN
bK
bN
"}
(30,1,1) = {"
Jl
aK
aK
aK
aK
pW
aK
aK
aK
bf
bf
bN
bK
bN
"}
(31,1,1) = {"
Jl
aK
aK
aK
aK
aK
aK
as
bf
bf
bN
bK
bK
bN
"}
