//MAP CONVERTED BY dmm2tgm.py THIS HEADER COMMENT PREVENTS RECONVERSION, DO NOT REMOVE
"aa" = (
/turf/open/ice/noweed,
/area/lv624/ground/river/central_river)
"ab" = (
/obj/structure/fence,
/turf/open/floor/plating/warnplate/northwest,
/area/lv624/ground/river/central_river)
"ac" = (
/obj/effect/decal/cleanable/blood/drip,
/turf/open/floor/plating/asteroidwarning/north,
/area/lv624/ground/river/central_river)
"ad" = (
/obj/structure/fence,
/turf/open/floor/plating/warnplate/northeast,
/area/lv624/ground/river/central_river)
"ae" = (
/obj/structure/fence,
/turf/open/floor/plating/warnplate/west,
/area/lv624/ground/river/central_river)
"af" = (
/obj/structure/fence,
/turf/open/floor/plating/warnplate/east,
/area/lv624/ground/river/central_river)
"ag" = (
/obj/structure/fence,
/turf/open/floor/plating/warnplate/southwest,
/area/lv624/ground/river/central_river)
"ah" = (
/obj/structure/fence,
/turf/open/floor/plating/warnplate/southeast,
/area/lv624/ground/river/central_river)
"ai" = (
/turf/open/auto_turf/snow/brown_base/layer1,
/area/lv624/ground/river/central_river)
"aj" = (
/turf/open/auto_turf/snow/brown_base/layer1,
/area/lv624/ground/jungle/north_jungle)
"al" = (
/obj/effect/decal/cleanable/blood/drip,
/turf/open/floor/plating/asteroidfloor/north,
/area/lv624/ground/river/central_river)
"iW" = (
/obj/effect/landmark/crap_item,
/turf/open/floor/plating/asteroidfloor/north,
/area/lv624/ground/river/central_river)
"km" = (
/obj/effect/landmark/lv624/fog_blocker,
/turf/open/ice/noweed,
/area/lv624/ground/river/central_river)
"lY" = (
/turf/open/floor/plating/asteroidwarning,
/area/lv624/ground/river/central_river)
"mq" = (
/obj/structure/machinery/colony_floodlight,
/turf/open/auto_turf/snow/brown_base/layer1,
/area/lv624/ground/river/central_river)
"mr" = (
/obj/effect/landmark/lv624/fog_blocker,
/turf/open/auto_turf/snow/brown_base/layer1,
/area/lv624/ground/river/central_river)
"ms" = (
/obj/structure/flora/jungle/planttop1,
/obj/effect/landmark/lv624/fog_blocker,
/turf/open/auto_turf/snow/brown_base/layer1,
/area/lv624/ground/river/central_river)
"mD" = (
/obj/effect/landmark/lv624/fog_blocker,
/turf/open/auto_turf/snow/brown_base/layer1,
/area/lv624/ground/jungle/north_jungle)
"mE" = (
/obj/structure/flora/jungle/plantbot1,
/turf/open/auto_turf/snow/brown_base/layer1,
/area/lv624/ground/jungle/north_east_jungle)
"qL" = (
/obj/effect/spawner/gibspawner/human,
/obj/effect/decal/cleanable/blood,
/turf/open/floor/plating/asteroidfloor/north,
/area/lv624/ground/river/central_river)
"xB" = (
/obj/effect/landmark/crap_item,
/turf/open/auto_turf/snow/brown_base/layer1,
/area/lv624/ground/jungle/north_jungle)
"yu" = (
/turf/closed/wall/strata_ice/jungle,
/area/lv624/ground/jungle/north_jungle)
"BW" = (
/obj/effect/decal/cleanable/blood,
/turf/open/floor/plating/asteroidfloor/north,
/area/lv624/ground/river/central_river)
"DX" = (
/turf/open/floor/plating/asteroidfloor/north,
/area/lv624/ground/river/central_river)
"EG" = (
/obj/effect/landmark/lv624/fog_blocker,
/turf/open/auto_turf/snow/brown_base/layer1,
/area/lv624/ground/jungle/north_east_jungle)
"Pz" = (
/turf/open/auto_turf/snow/brown_base/layer1,
/area/lv624/ground/jungle/north_east_jungle)
"Uh" = (
/obj/effect/landmark/corpsespawner/miner,
/obj/effect/decal/cleanable/blood,
/turf/open/floor/plating/asteroidfloor/north,
/area/lv624/ground/river/central_river)
"Yw" = (
/turf/open/floor/plating/asteroidwarning/north,
/area/lv624/ground/river/central_river)

(1,1,1) = {"
mr
km
aa
aa
aa
aa
aa
aa
ai
ai
mD
aj
aj
"}
(2,1,1) = {"
mr
aa
aa
aa
aa
aa
aa
aa
ai
mr
aj
aj
aj
"}
(3,1,1) = {"
mr
aa
aa
aa
aa
aa
aa
aa
mr
ai
aj
aj
aj
"}
(4,1,1) = {"
mr
aa
aa
aa
aa
aa
aa
aa
mr
ai
xB
aj
yu
"}
(5,1,1) = {"
mr
km
km
km
km
km
km
km
mr
mq
aj
aj
yu
"}
(6,1,1) = {"
ab
ae
ae
ae
ae
ae
ae
ae
ag
ai
aj
aj
aj
"}
(7,1,1) = {"
ac
al
Uh
DX
DX
DX
iW
DX
lY
ai
aj
aj
aj
"}
(8,1,1) = {"
Yw
DX
DX
DX
BW
al
al
qL
lY
ai
aj
aj
aj
"}
(9,1,1) = {"
Yw
DX
iW
DX
DX
DX
DX
DX
lY
ai
aj
aj
aj
"}
(10,1,1) = {"
ad
af
af
af
af
af
af
af
ah
ai
aj
aj
aj
"}
(11,1,1) = {"
mr
km
km
km
km
km
km
km
mr
mq
aj
aj
aj
"}
(12,1,1) = {"
mr
aa
aa
aa
aa
aa
aa
aa
ai
mr
Pz
Pz
Pz
"}
(13,1,1) = {"
km
aa
aa
aa
aa
aa
aa
ai
ai
ms
mE
EG
Pz
"}
