//MAP CONVERTED BY dmm2tgm.py THIS HEADER COMMENT PREVENTS RECONVERSION, DO NOT REMOVE
"cR" = (
/obj/structure/flora/bush/ausbushes/reedbush,
/turf/closed/wall/strata_ice/jungle,
/area/lv624/ground/river/east_river)
"df" = (
/turf/closed/wall/strata_ice/jungle,
/area/lv624/ground/barrens/south_eastern_jungle_barrens)
"gn" = (
/obj/structure/flora/bush/ausbushes/var3/sunnybush,
/turf/open/auto_turf/snow/brown_base/layer1,
/area/lv624/ground/barrens/south_eastern_jungle_barrens)
"gs" = (
/obj/structure/flora/bush/ausbushes/ausbush,
/turf/open/auto_turf/snow/brown_base/layer1,
/area/lv624/ground/jungle/east_jungle)
"lm" = (
/obj/structure/flora/bush/ausbushes/grassybush,
/turf/open/auto_turf/snow/brown_base/layer1,
/area/lv624/ground/river/east_river)
"lD" = (
/obj/structure/flora/bush/ausbushes/var3/stalkybush,
/obj/effect/landmark/lv624/fog_blocker,
/turf/open/ice/noweed,
/area/lv624/ground/river/east_river)
"mK" = (
/obj/structure/flora/bush/ausbushes/reedbush,
/turf/closed/wall/strata_ice/jungle,
/area/lv624/ground/jungle/east_jungle)
"nG" = (
/turf/closed/wall/strata_ice/jungle,
/area/lv624/ground/river/east_river)
"pf" = (
/obj/structure/flora/bush/ausbushes/reedbush,
/turf/closed/wall/strata_ice/jungle,
/area/lv624/ground/barrens/south_eastern_jungle_barrens)
"rP" = (
/obj/structure/flora/bush/ausbushes/reedbush,
/turf/open/ice/noweed,
/area/lv624/ground/river/east_river)
"sn" = (
/turf/closed/wall/strata_ice/jungle,
/area/lv624/ground/jungle/east_jungle)
"tN" = (
/turf/open/auto_turf/snow/brown_base/layer1,
/area/lv624/ground/barrens/south_eastern_jungle_barrens)
"tT" = (
/turf/open/auto_turf/snow/brown_base/layer1,
/area/lv624/ground/jungle/east_jungle)
"zT" = (
/obj/structure/flora/bush/ausbushes/var3/ppflowers,
/turf/open/auto_turf/snow/brown_base/layer1,
/area/lv624/ground/barrens/south_eastern_jungle_barrens)
"Ek" = (
/turf/open/ice/noweed,
/area/lv624/ground/river/east_river)
"El" = (
/obj/structure/flora/bush/ausbushes/var3/stalkybush,
/turf/open/ice/noweed,
/area/lv624/ground/river/east_river)
"Fj" = (
/obj/structure/flora/jungle/alienplant1,
/turf/open/auto_turf/snow/brown_base/layer1,
/area/lv624/ground/river/east_river)
"GI" = (
/obj/effect/landmark/lv624/fog_blocker,
/turf/open/auto_turf/snow/brown_base/layer1,
/area/lv624/ground/river/east_river)
"Kd" = (
/turf/open/auto_turf/snow/brown_base/layer1,
/area/lv624/ground/river/east_river)
"PE" = (
/obj/structure/flora/bush/ausbushes/var3/fullgrass,
/turf/open/auto_turf/snow/brown_base/layer1,
/area/lv624/ground/jungle/east_jungle)
"Qb" = (
/obj/structure/flora/bush/ausbushes/var3/stalkybush,
/turf/open/auto_turf/snow/brown_base/layer1,
/area/lv624/ground/river/east_river)
"TQ" = (
/obj/effect/landmark/lv624/fog_blocker,
/turf/open/ice/noweed,
/area/lv624/ground/river/east_river)
"WK" = (
/obj/structure/flora/bush/ausbushes/reedbush,
/turf/open/auto_turf/snow/brown_base/layer1,
/area/lv624/ground/jungle/east_jungle)
"Xe" = (
/obj/structure/flora/bush/ausbushes/lavendergrass,
/turf/open/auto_turf/snow/brown_base/layer1,
/area/lv624/ground/barrens/south_eastern_jungle_barrens)
"Xq" = (
/obj/structure/flora/bush/ausbushes/var3/fullgrass,
/turf/open/auto_turf/snow/brown_base/layer1,
/area/lv624/ground/barrens/south_eastern_jungle_barrens)

(1,1,1) = {"
tN
gn
tN
GI
lD
TQ
Ek
Ek
Ek
Ek
Ek
rP
Ek
TQ
GI
tT
tT
tT
tT
tT
"}
(2,1,1) = {"
tN
tN
tN
tN
tN
TQ
TQ
TQ
Ek
El
Ek
TQ
TQ
TQ
Kd
tT
PE
tT
tT
tT
"}
(3,1,1) = {"
tN
tN
tN
tN
tN
tN
Fj
GI
TQ
TQ
TQ
TQ
Ek
Kd
Kd
PE
tT
tT
tT
tT
"}
(4,1,1) = {"
tN
tN
tN
tN
tN
tN
tN
Kd
TQ
TQ
Kd
Kd
Kd
Kd
tT
tT
tT
tT
tT
tT
"}
(5,1,1) = {"
tN
tN
tN
Xq
tN
tN
tN
Kd
Fj
Kd
Qb
Kd
Kd
tT
tT
tT
tT
tT
tT
tT
"}
(6,1,1) = {"
gn
tN
tN
tN
tN
tN
tN
tN
Kd
Kd
Kd
Kd
Kd
tT
tT
tT
tT
tT
tT
tT
"}
(7,1,1) = {"
tN
Xq
tN
zT
tN
tN
tN
tN
Kd
Kd
Kd
Kd
Kd
WK
tT
PE
tT
tT
tT
tT
"}
(8,1,1) = {"
Xe
tN
tN
tN
Xq
tN
tN
tN
lm
Kd
Kd
Kd
Kd
tT
tT
tT
tT
gs
tT
tT
"}
(9,1,1) = {"
df
df
df
df
df
df
pf
df
nG
nG
nG
nG
cR
sn
mK
sn
sn
sn
sn
sn
"}
