//MAP CONVERTED BY dmm2tgm.py THIS HEADER COMMENT PREVENTS RECONVERSION, DO NOT REMOVE
"aq" = (
/obj/structure/flora/jungle/vines/heavy,
/turf/open/auto_turf/snow/brown_base/layer1,
/area/lv624/ground/jungle/south_west_jungle)
"ar" = (
/obj/structure/flora/jungle/vines/heavy,
/obj/structure/flora/jungle/vines/light_2,
/turf/open/auto_turf/snow/brown_base/layer1,
/area/lv624/ground/jungle/south_west_jungle)
"fv" = (
/obj/effect/landmark/objective_landmark/far,
/turf/open/auto_turf/snow/brown_base/layer1,
/area/lv624/ground/jungle/south_west_jungle)
"gb" = (
/obj/structure/flora/bush/ausbushes/ywflowers,
/turf/open/auto_turf/snow/brown_base/layer1,
/area/lv624/ground/jungle/south_west_jungle)
"ja" = (
/obj/structure/flora/jungle/vines/light_1,
/obj/structure/flora/jungle/vines/heavy,
/turf/open/auto_turf/snow/brown_base/layer1,
/area/lv624/ground/jungle/south_west_jungle)
"lf" = (
/obj/structure/flora/jungle/vines/light_3,
/turf/closed/wall/strata_ice/jungle,
/area/lv624/ground/jungle/south_west_jungle)
"lR" = (
/obj/item/weapon/yautja/duelknife{
	desc = "A curved blade made of a strange material. It looks both old and very sharp.";
	force = 30;
	name = "\improper alien blade";
	throwforce = 26
	},
/turf/open/auto_turf/snow/brown_base/layer1,
/area/lv624/ground/jungle/south_west_jungle)
"ny" = (
/obj/structure/flora/bush/ausbushes/lavendergrass,
/turf/open/auto_turf/snow/brown_base/layer1,
/area/lv624/ground/jungle/south_west_jungle)
"oD" = (
/turf/open/auto_turf/snow/brown_base/layer1,
/area/lv624/ground/jungle/south_west_jungle)
"oO" = (
/obj/structure/flora/jungle/vines/light_3,
/turf/open/auto_turf/snow/brown_base/layer1,
/area/lv624/ground/jungle/south_west_jungle)
"qZ" = (
/obj/structure/flora/bush/ausbushes/var3/leafybush,
/turf/open/auto_turf/snow/brown_base/layer1,
/area/lv624/ground/jungle/south_west_jungle)
"ui" = (
/obj/structure/flora/bush/ausbushes/var3/sparsegrass,
/turf/open/auto_turf/snow/brown_base/layer1,
/area/lv624/ground/jungle/south_west_jungle)
"up" = (
/obj/structure/flora/bush/ausbushes/reedbush,
/turf/open/auto_turf/snow/brown_base/layer1,
/area/lv624/ground/jungle/south_west_jungle)
"uV" = (
/obj/structure/flora/jungle/plantbot1,
/turf/open/auto_turf/snow/brown_base/layer1,
/area/lv624/ground/jungle/south_west_jungle)
"AQ" = (
/obj/structure/flora/jungle/vines/light_3,
/obj/structure/flora/jungle/vines/heavy,
/turf/open/auto_turf/snow/brown_base/layer1,
/area/lv624/ground/jungle/south_west_jungle)
"Bl" = (
/obj/structure/flora/bush/ausbushes/genericbush,
/turf/open/auto_turf/snow/brown_base/layer1,
/area/lv624/ground/jungle/south_west_jungle)
"El" = (
/obj/structure/flora/bush/ausbushes/var3/fernybush,
/turf/open/auto_turf/snow/brown_base/layer1,
/area/lv624/ground/jungle/south_west_jungle)
"FE" = (
/obj/effect/landmark/hunter_primary,
/turf/open/auto_turf/snow/brown_base/layer1,
/area/lv624/ground/jungle/south_west_jungle)
"Ge" = (
/obj/structure/flora/jungle/vines/light_2,
/turf/open/auto_turf/snow/brown_base/layer1,
/area/lv624/ground/jungle/south_west_jungle)
"Lv" = (
/obj/effect/landmark/lv624/xeno_tunnel,
/obj/structure/flora/jungle/vines/light_3,
/obj/structure/flora/jungle/vines/light_2,
/turf/open/auto_turf/snow/brown_base/layer1,
/area/lv624/ground/jungle/south_west_jungle)
"LF" = (
/obj/structure/flora/bush/ausbushes/ausbush,
/turf/open/auto_turf/snow/brown_base/layer1,
/area/lv624/ground/jungle/south_west_jungle)
"LM" = (
/obj/structure/flora/jungle/vines/light_2,
/obj/effect/landmark/lv624/xeno_tunnel,
/turf/open/gm/grass/grass1,
/area/lv624/ground/jungle/south_west_jungle)
"LW" = (
/turf/closed/wall/strata_ice/jungle,
/area/lv624/ground/jungle/south_west_jungle)
"Ng" = (
/obj/effect/landmark/lizard_spawn,
/turf/open/auto_turf/snow/brown_base/layer1,
/area/lv624/ground/jungle/south_west_jungle)
"Nq" = (
/obj/structure/flora/bush/ausbushes/var3/sunnybush,
/turf/open/auto_turf/snow/brown_base/layer1,
/area/lv624/ground/jungle/south_west_jungle)
"NE" = (
/obj/structure/flora/jungle/vines/light_2,
/obj/structure/flora/jungle/vines/heavy,
/turf/open/auto_turf/snow/brown_base/layer1,
/area/lv624/ground/jungle/south_west_jungle)
"Rj" = (
/obj/structure/flora/jungle/vines/light_3,
/obj/structure/flora/jungle/vines/light_1,
/turf/open/auto_turf/snow/brown_base/layer1,
/area/lv624/ground/jungle/south_west_jungle)
"RS" = (
/obj/structure/flora/jungle/vines/light_1,
/turf/open/auto_turf/snow/brown_base/layer1,
/area/lv624/ground/jungle/south_west_jungle)
"TE" = (
/obj/structure/flora/jungle/vines/light_2,
/turf/closed/wall/strata_ice/jungle,
/area/lv624/ground/jungle/south_west_jungle)
"XG" = (
/obj/effect/landmark/yautja_teleport,
/turf/open/auto_turf/snow/brown_base/layer1,
/area/lv624/ground/jungle/south_west_jungle)

(1,1,1) = {"
lR
aq
oO
LW
LW
oO
aq
LM
LW
LW
LW
aq
Lv
LW
"}
(2,1,1) = {"
oO
oO
oO
LW
TE
NE
aq
oO
oO
LW
TE
ja
ar
Rj
"}
(3,1,1) = {"
aq
RS
Ge
LW
lf
oD
Bl
LW
LW
LW
TE
AQ
aq
aq
"}
(4,1,1) = {"
RS
RS
Ge
Ge
aq
oD
oD
LW
LW
oD
oD
Ge
ja
aq
"}
(5,1,1) = {"
LW
aq
oO
Ge
oD
oD
oD
LW
oD
oD
Ng
oD
Ge
AQ
"}
(6,1,1) = {"
LW
oD
oO
oD
oD
oD
oD
oD
oD
oD
XG
oD
RS
LW
"}
(7,1,1) = {"
Ge
Nq
oD
oD
oD
oD
fv
oD
oD
oD
oD
oD
oD
oD
"}
(8,1,1) = {"
uV
oD
oD
oD
oD
oD
oD
oD
oD
Ng
oD
oD
oD
El
"}
(9,1,1) = {"
RS
oD
oD
oD
oD
oD
oD
oD
oD
oD
LW
FE
LW
LW
"}
(10,1,1) = {"
oO
oD
oD
oD
oD
oD
oD
oD
oD
oD
LW
LW
LW
LW
"}
(11,1,1) = {"
LW
gb
ui
oD
oD
oD
oD
up
oD
oD
LW
LW
LW
LW
"}
(12,1,1) = {"
Ge
oD
oD
oD
RS
LW
LW
oD
oD
LF
oD
oD
LW
LW
"}
(13,1,1) = {"
RS
oD
RS
RS
Ge
LW
LW
LW
oD
oD
oD
oD
oD
LW
"}
(14,1,1) = {"
Ge
qZ
LW
aq
AQ
RS
LW
LW
LW
LW
oD
ny
oD
LW
"}
(15,1,1) = {"
LW
LW
LW
LF
aq
aq
LW
LW
LW
LW
LW
oD
oD
LW
"}
