//MAP CONVERTED BY dmm2tgm.py THIS HEADER COMMENT PREVENTS RECONVERSION, DO NOT REMOVE
"aa" = (
/turf/open/auto_turf/snow/brown_base/layer1,
/area/lv624/ground/jungle/south_east_jungle)
"ab" = (
/obj/structure/flora/jungle/vines/light_3,
/turf/open/auto_turf/snow/brown_base/layer1,
/area/lv624/ground/jungle/south_east_jungle)
"ac" = (
/obj/structure/flora/jungle/vines/heavy,
/turf/open/auto_turf/snow/brown_base/layer1,
/area/lv624/ground/jungle/south_east_jungle)
"al" = (
/obj/structure/flora/jungle/vines/light_2,
/obj/structure/flora/jungle/vines/heavy,
/turf/open/auto_turf/snow/brown_base/layer1,
/area/lv624/ground/jungle/south_east_jungle)
"aK" = (
/turf/closed/wall/strata_ice/jungle,
/area/lv624/ground/jungle/south_east_jungle)
"br" = (
/obj/structure/flora/bush/ausbushes/ywflowers,
/turf/open/floor/sandstone/runed,
/area/lv624/ground/jungle/south_east_jungle)
"cC" = (
/obj/structure/flora/jungle/vines/light_1,
/turf/closed/wall/strata_ice/jungle,
/area/lv624/lazarus/landing_zones/lz1)
"gO" = (
/obj/structure/flora/jungle/vines/light_3,
/turf/open/gm/grass/grass1,
/area/lv624/lazarus/landing_zones/lz1)
"gU" = (
/obj/structure/flora/jungle/vines/heavy{
	pixel_y = 26
	},
/obj/structure/flora/jungle/vines/light_2{
	pixel_y = -22
	},
/turf/open/floor/sandstone/runed,
/area/lv624/ground/jungle/south_east_jungle)
"jc" = (
/obj/structure/flora/jungle/vines/heavy,
/turf/open/gm/grass/grass1,
/area/lv624/ground/jungle/south_east_jungle)
"kd" = (
/obj/structure/flora/jungle/planttop1,
/turf/open/auto_turf/snow/brown_base/layer1,
/area/lv624/ground/jungle/south_east_jungle)
"lV" = (
/obj/structure/flora/jungle/vines/heavy{
	pixel_y = 26
	},
/obj/structure/flora/jungle/vines/light_3,
/turf/open/auto_turf/snow/brown_base/layer1,
/area/lv624/ground/jungle/south_east_jungle)
"nI" = (
/obj/structure/flora/jungle/vines/heavy,
/turf/open/gm/grass/grass1,
/area/lv624/lazarus/landing_zones/lz1)
"qo" = (
/turf/open/gm/grass/grass1,
/area/lv624/ground/jungle/south_east_jungle)
"rA" = (
/obj/structure/flora/jungle/vines/heavy{
	pixel_y = 26
	},
/turf/closed/wall/strata_ice/jungle,
/area/lv624/ground/jungle/south_east_jungle)
"uk" = (
/obj/structure/flora/jungle/vines/heavy{
	pixel_y = 26
	},
/turf/closed/wall/mineral/sandstone/runed,
/area/lv624/ground/jungle/south_east_jungle)
"un" = (
/obj/structure/flora/bush/ausbushes/reedbush,
/turf/open/floor/sandstone/runed,
/area/lv624/ground/jungle/south_east_jungle)
"ur" = (
/obj/structure/flora/jungle/vines/light_2,
/turf/open/auto_turf/snow/brown_base/layer1,
/area/lv624/ground/jungle/south_east_jungle)
"vt" = (
/obj/effect/landmark/lizard_spawn,
/turf/open/auto_turf/snow/brown_base/layer0,
/area/lv624/ground/jungle/south_east_jungle)
"wQ" = (
/obj/structure/flora/jungle/vines/heavy{
	pixel_x = -28
	},
/turf/open/auto_turf/snow/brown_base/layer1,
/area/lv624/ground/jungle/south_east_jungle)
"xk" = (
/turf/closed/wall/mineral/sandstone/runed/decor,
/area/lv624/ground/jungle/south_east_jungle)
"yg" = (
/obj/structure/flora/jungle/vines/heavy{
	pixel_y = 26
	},
/obj/structure/flora/jungle/vines/light_3,
/turf/open/floor/sandstone/runed,
/area/lv624/ground/jungle/south_east_jungle)
"zg" = (
/obj/structure/flora/jungle/vines/light_3,
/turf/closed/wall/strata_ice/jungle,
/area/lv624/lazarus/landing_zones/lz1)
"Be" = (
/obj/structure/flora/jungle/vines/heavy,
/turf/open/floor/sandstone/runed,
/area/lv624/ground/jungle/south_east_jungle)
"CW" = (
/obj/structure/flora/jungle/vines/heavy{
	pixel_y = 26
	},
/obj/effect/decal/cleanable/cobweb,
/turf/open/auto_turf/snow/brown_base/layer0,
/area/lv624/ground/jungle/south_east_jungle)
"EZ" = (
/obj/structure/flora/jungle/vines/light_3,
/turf/open/floor/sandstone/runed,
/area/lv624/ground/jungle/south_east_jungle)
"Kj" = (
/obj/effect/landmark/lizard_spawn,
/turf/open/floor/sandstone/runed,
/area/lv624/ground/jungle/south_east_jungle)
"LV" = (
/turf/open/gm/grass/grass1,
/area/lv624/lazarus/landing_zones/lz1)
"LW" = (
/turf/closed/wall/strata_ice/jungle,
/area/lv624/lazarus/landing_zones/lz1)
"NU" = (
/obj/structure/flora/jungle/vines/heavy{
	pixel_y = 26
	},
/turf/open/auto_turf/snow/brown_base/layer0,
/area/lv624/ground/jungle/south_east_jungle)
"Tl" = (
/obj/structure/flora/jungle/plantbot1,
/turf/open/auto_turf/snow/brown_base/layer1,
/area/lv624/ground/jungle/south_east_jungle)
"Uc" = (
/obj/structure/flora/jungle/vines/heavy{
	pixel_y = 26
	},
/turf/open/floor/sandstone/runed,
/area/lv624/ground/jungle/south_east_jungle)
"UA" = (
/obj/structure/flora/jungle/vines/light_3,
/turf/open/gm/grass/grass1,
/area/lv624/ground/jungle/south_east_jungle)
"VR" = (
/obj/effect/landmark/yautja_teleport,
/turf/open/auto_turf/snow/brown_base/layer1,
/area/lv624/ground/jungle/south_east_jungle)
"Wl" = (
/turf/closed/wall/mineral/sandstone/runed,
/area/lv624/ground/jungle/south_east_jungle)
"Wp" = (
/obj/structure/flora/jungle/vines/light_2{
	pixel_y = -22
	},
/turf/open/auto_turf/snow/brown_base/layer1,
/area/lv624/ground/jungle/south_east_jungle)
"Wt" = (
/obj/structure/flora/jungle/vines/light_2{
	pixel_y = -22
	},
/turf/closed/wall/mineral/sandstone/runed,
/area/lv624/ground/jungle/south_east_jungle)
"Xl" = (
/turf/open/auto_turf/snow/brown_base/layer0,
/area/lv624/ground/jungle/south_east_jungle)
"Xy" = (
/turf/open/floor/sandstone/runed,
/area/lv624/ground/jungle/south_east_jungle)
"Xz" = (
/obj/effect/landmark/monkey_spawn,
/turf/open/auto_turf/snow/brown_base/layer0,
/area/lv624/ground/jungle/south_east_jungle)
"XB" = (
/obj/structure/flora/jungle/vines/light_1,
/turf/open/auto_turf/snow/brown_base/layer1,
/area/lv624/ground/jungle/south_east_jungle)
"XS" = (
/obj/structure/flora/jungle/vines/heavy,
/turf/closed/wall/mineral/sandstone/runed,
/area/lv624/ground/jungle/south_east_jungle)
"Ya" = (
/obj/effect/landmark/lv624/xeno_tunnel,
/turf/open/auto_turf/snow/brown_base/layer1,
/area/lv624/ground/jungle/south_east_jungle)
"Yz" = (
/obj/structure/flora/jungle/vines/heavy{
	pixel_y = 24
	},
/turf/closed/wall/strata_ice/jungle,
/area/lv624/ground/jungle/south_east_jungle)
"Zi" = (
/obj/structure/flora/jungle/vines/heavy{
	pixel_y = 24
	},
/obj/structure/flora/jungle/vines/light_1,
/turf/open/auto_turf/snow/brown_base/layer1,
/area/lv624/ground/jungle/south_east_jungle)
"Zp" = (
/obj/structure/flora/bush/ausbushes/var3/sparsegrass,
/turf/open/auto_turf/snow/brown_base/layer1,
/area/lv624/ground/jungle/south_east_jungle)

(1,1,1) = {"
LV
nI
gO
LW
LW
ac
ur
XB
ac
XB
aa
aa
aa
aa
"}
(2,1,1) = {"
gO
zg
gO
LW
aK
al
ab
ab
aa
aa
aa
aa
aa
ab
"}
(3,1,1) = {"
nI
LW
LW
LW
ab
Wl
Wl
aa
aa
XS
jc
ac
aa
aK
"}
(4,1,1) = {"
cC
LW
ur
ur
ac
Wl
CW
Xl
Xl
XS
XS
XS
aK
aK
"}
(5,1,1) = {"
LW
jc
ac
aa
ab
xk
EZ
Xl
Xy
Xy
EZ
Wl
Yz
aK
"}
(6,1,1) = {"
LW
LW
ur
aa
aa
Wl
Uc
Xy
Xy
Xy
un
xk
rA
aK
"}
(7,1,1) = {"
qo
UA
ac
aa
aa
Wt
gU
Xz
Xy
vt
Xl
Xl
aa
aa
"}
(8,1,1) = {"
qo
qo
aa
aa
aa
xk
EZ
Xy
Xy
Xy
Xl
Xl
aa
aa
"}
(9,1,1) = {"
qo
aK
kd
Tl
aK
Wl
yg
Kj
Xl
br
EZ
Wl
Zi
aa
"}
(10,1,1) = {"
aK
aK
aa
aa
aa
Wp
EZ
Xy
Xy
EZ
Be
Wl
lV
aa
"}
(11,1,1) = {"
qo
qo
Zp
aa
aa
Wp
EZ
Xy
Xy
EZ
uk
Wl
XB
aa
"}
(12,1,1) = {"
qo
qo
qo
aK
aa
Wp
NU
yg
EZ
Xl
aa
wQ
aa
aa
"}
(13,1,1) = {"
qo
qo
aK
aK
aK
Wl
Wl
Wl
xk
Wl
aa
aa
aa
aa
"}
(14,1,1) = {"
aK
aK
aK
aK
aK
aK
aK
Ya
aa
aa
aa
VR
aa
aK
"}
(15,1,1) = {"
aK
aK
aK
aK
aK
aK
aK
aK
aa
aa
aa
aa
aK
aK
"}
